to have	έχω
to say	λέγω
to do	κάνω
to go	πηγαίνω
to see	βλέπω
to make	κάνω
to know	ξέρω
to want	θέλω
to take	παίρνω
to believe	πιστεύω
day	η ημέρα
woman	η γυναίκα
time	η ώρα
night	η νύχτα
story	η ιστορία
door	η πόρτα
mother	η μητέρα
chocolate	η σοκολάτα
goat	η κατσίκα
sea	η θάλασσα
more	περισσότερος
large	μεγάλος
alone	μόνος
all	όλος
young	νέος
white	άσπρος
same	ίδιος
black	μαύρος
new	καινούριος
last	τελευταίος
year	οχρόνος
world	ο κόσμος
fear	οφόβος
wall	ο τοίχος
son	ο γιος
sun	ο ήλιος
friend	ο φίλος
pain	ο πόνος
noise	οθόρυβος
road	οδρόμος
to speak	μιλώ
to ask	ρωτώ
to pass	περνώ
to hold	κρατώ
to live	ζώ
to stop	σταματώ
to follow	ακολουθώ
to laugh	γελώ
to walk	περπατώ
to seek	αναζητώ
room	το δωμάτιο
face	το πρόσωπο
horse	το αλόγο
book	το βιβλίο
car	το αυτοκίνητο
window	το παράθυρο
wood	το ξύλο
iron	το σίδηρο
tree	το δέντρο
eye	το μάτι
small	μικρός
right	δεξιός
old	παλαιός
high	ψηλός
low	χαμηλός
poor	φτωχός
clean	καθαρός
fat	χοντρός
strong	δυνατός
TRUE	αληθινός
king	ο βασιλιάς
grandfather	ο παπούς
soldier	ο στρατιώτης
coffee	ο καφές
manager	ο διευθυντής
student	ο φοιτητής
butcher	ο χασάπης
map	ο χάρτης
mirror	ο καθρέφτης
farmer	ο αγρότης
to arrive	φθάνω
to run	τρέχω
to put	βάζω
to find	βρίσκω
to leave	φεύγω
to give	δίνω
to remain	παραμένω
to calculate	υπολογίζω
to flatter	κολακεύω
to hear	ακούω
receipt	η απόδειξη
word	η λέξη
love	η αγάπη
earth	η γη
daughter	η κόρη
pleasure	η ευχαρίστηση
town	η πόλη
nose	η μύτη
need	η ανάγκη
sense	η αίσθηση
red	κόκκινος
sure	σίγουρος
full	γεμάτος
other	άλλος
empty	άδειος
less	λιγότερος
happy	ευτυχισμένος
better	καλύτερος
green	πράσινος
grey	γκρίζος
doctor	ο ιατρός
brother	ο αδελφός
sky	ο ουρανός
hip	ο γοφός
number	ο αριθμός
throat	ο λαιμός
weather	ο καιρός
driver	ο οδηγός
copper	ο χαλκός
juice	ο χυμός
to throw	πετώ
to forget	ξεχνώ
to try	προσπαθώ
to reply	απαντώ
to converse	συνομιλώ
to slide	γλιστρώ
to strike	χτυπώ
to explain	εξηγώ
to dwell	κατοικώ
to pull	τραβώ
child	το παιδί
wine	το κρασί
evening	το βράδυ
morning	το πρωί
place	το μέρος
water	το νερό
fact	το γεγονός
fault	το λάθος
breakfast	το πρωινό
end	το τέλος
clear	καθαρός
good	καλός
little	μικρός
open	ανοικτός
hard	σκληρός
left	αριστερός
dear	αγαπητός
simple	απλός
soft	μαλακός
dry	στεγνός
man	ο άνδρας
father	ο πατέρας
air	ο αέρας
month	ο μήνας
neighbor	ο γείτονας
sign	ο πίνακας
winter	ο χειμώνας
painting	ο πίνακας
elbow	ο αγκώνας
barber	ο κουρέας
to understand	καταλαβαίνω
to open	ανοίγω
to die	πεθαίνω
to lose	χάνω
to draw	ζωγραφίζω
to carry	μεταφέρω
to expect	περιμένω
to finish	τελειώνω
to begin	αρχίζω
to fall	πέφτω
side	η πλευρά
job	η δουλειά
glance	η ματιά
heart	η καρδιά
market	η αγορά
shadow	η σκιά
fire	η φωτιά
grandmother	η γιαγιά
smell	η μυρωδιά
joy	η χαρά
difficult	δύσκολος
yellow	κίτρινος
ready	έτοιμος
free	ελεύθερος
dirty	βρώμικος
similar	όμοιος
cold	κρύος
strange	παράξενος
FALSE	ψεύτικος
sick	άρρωστος
dog	ο σκύλος
shoulder	ο ώμος
reason	ο λόγος
garden	ο κήπος
war	ο πόλεμος
ice	ο πάγος
death	ο θάνατος
frog	ο βάτραχος
wind	ο άνεμος
sleep	ο ύπνος
to sell	πουλώ
to hang	κρεμώ
to sing	τραγουδώ
to depart	αναχωρώ
to recommend	συνιστώ
to smile	χαμογελώ
to grow	καλλιεργώ
to fly	πετώ
to drive	οδηγώ
to roll	κυλώ
table	το τραπέζι
hand	το χέρι
head	το κεφάλι
girl	το κορίτσι
house	το σπίτι
foot	το πόδι
pig	το γουρούνι
bed	το κρεβάτι
arm	το χέρι
fir	το έλατο
tall	ψηλός
crisp	τραγανιστός
vexatious	οχληρός
cleaned	καθαρός
jellied	πηχτός
vocational	επαγγελματικός
stooping	καμπουρωτός
grimy	ρυπαρός
revolting	αηδιαστικός
maiden	παρθενικός
baker	οφουρνάρης
pail	ο κουβάς
miser	ο τσιγγούνης
north	ο βοριάς
smith	ο σιδεράς
burglar	ο διαρρήκτης
pilgrim	ο προσκυνητής
chart	ο χάρτης
reader	ο αναγνώστης
vagabond	ο αλήτης
to play	παίζω
to read	διαβάζω
to eat	τρώω
to raise	σηκώνω
to write	γράφω
to push	σπρώχνω
to learn	μαθαίνω
to win	κερδίζω
to decide	αποφασίζω
to offer	προσφέρω
voice	η φωνή
moment	η στιγμή
shore	η ακτή
street	η οδός
sister	η αδελφή
wife	η σύζυγος
silence	η σιωπή
instant	η στιγμή
method	η μέθοδος
rain	η βροχή
easy	εύκολος
sad	λυπημένος
careless	απρόσεκτος
holy	άγιος
stupid	ανόητος
wild	άγριος
scarce	σπάνιος
quiet	ήσυχος
ordinary	συνηθισμένος
agreeable	ευχάριστος
tobacco	ο καπνός
neck	ο λαιμός
anger	ο θυμός
wage	ο μισθός
gardener	ο κηπουρός
ocean	ο ωκεανός
thunderbolt	ο κεραυνός
cross	ο σταυρός
heap	ο σωρός
respect	ο σεβασμός
to thank	ευχαριστώ
to answer	απαντώ
to request	ζητώ
to talk	μιλώ
to dare	τολμώ
to please	ικανοποιώ
to keep	κρατώ
to shoot	πυροβολώ
to punish	τιμωρώ
to discuss	συζητώ
thing	το πράγμα
body	το σώμα
name	το όνομα
deck	το κατάστρωμα
milk	το γάλα
letter	το γράμμα
dress	το φόρεμα
mouth	το στόμα
afternoon	το απόγεμα
parcel	το δέμα
obligatory	υποχρεωτικός
officious	υπεροπτικός
perishable	φθαρτός
conditional	προσωρινός
steady	σταθερός
gleaming	αστραφτερός
grim	βλοσυρός
commendatory	επαινετικός
somber	σκοτεινός
consumptive	φυματικός
rule	ο κανόνας
elephant	ο ελέφαντας
chest	ο θώρακας
secretary	ο γραμματέας
prince	ο πρίγκηπας
witness	ο μάρτυρας
watchman	ο φύλακας
author	ο συγγραφέας
deceiver	ο απατεώνας
martyr	ο μάρτυρας
to resemble	μοιάζω
to weep	κλαίω
to show	δείχνω
to serve	σερβίρω
to burn	καίω
to buy	αγοράζω
to approach	πλησιάζω
to clear	καθαρίζω
to seize	αρπάζω
to assure	διαβεβαιώνω
desire	η επιθυμία
idea	η ιδέα
boot	η μπότα
hour	η ώρα
family	η οικογένεια
duck	η πάπια
age	η ηλικία
doubt	η αμφιβωλία
carpet	η μοκέτα
butterfly	η πεταλούδα
curious	περίεργος
enormous	τεράστιος
ugly	απαίσιος
numerous	πολυάριθμος
such	τέτοιος
useful	χρήσιμος
brave	γενναίος
entire	ολόκληρος
public	δημόσιος
fresh	φρέσκος
marriage	ο γάμος
donkey	ο γάιδαρος
husband	ο σύζυγος
uncle	ο θείος
merchant	ο έμπορος
waiter	οσερβιτόρος
stove	οφούρνος
teacher	ο δάσκαλος
guest	ο φιλοξενούμενος
cousin	ο ξάδελφος
to hate	μισώ
to last	διαρκώ
to deceive	απατώ
to fight	πολεμώ
to divide	διαιρώ
to survive	επιζώ
to perfect	τελειοποιώ
to exclaim	αναφωνώ
to beat	νικώ
to ignore	αγνοώ
knee	το γόνατο
office	το γραφείο
hospital	το νοσοκομείο
telephone	το τηλέφωνο
finger	το δάτκτυλο
school	το σχολείο
passage	το κείμενο
leaf	το φύλλο
measure	το μέτρο
tea	το τσάι
amatory	ερωτικός
homemade	σπιτικός
this	αυτός
sheltering	προστατευτικός
flimsy	ψιλός
challenging	προκλητικός
occasional	περιοδικός
winsome	θελκτικός
sneering	ειρωνικός
cultural	πολιτιστικός
ploughman	ο ζευγολάτης
ambassador	ο πρεσβευτής
bookkeeper	ο λογιστής
hermit	ο ερημίτης
warrior	ο πολεμιστής
editor	ο συντάκτης
sailor	ο ναύτης
milkman	ο γαλατάς
kinsman	ο συγγενής
hedge	ο φράκτης
to choose	διαλέγω
to lean	κλίνω
to discover	ανακαλύπτω
to build	χτίζω
to pay	πληρώνω
to tremble	τρέμω
to cut	κόβω
to receive	λαμβάνω
to surround	περιτριγυρίζω
to suffer	υποφέρω
back	η πλάτη
thought	η σκέψη
bride	η νύφη
question	η ερώτηση
fog	η ομίχλη
reply	η απάντηση
fall	η πτώση
birth	η γέννηση
study	η μελέτη
sight	η όραση
impossible	αδύνατος
unknown	άγνωστος
necessary	αναγκαίος
flat	επίπεδος
dangerous	επικίνδυνος
comfortable	άνετος
perfect	τέλειος
famous	διάσημος
splendid	υπέροχος
human	ανθρώπινος
youth	ο νεαρός
actor	ο ηθοποιός
treasure	ο θησαυρός
hesitation	ο δισταγμός
sentinel	ο σκοπός
derision	ο χλευασμός
sprout	ο βλαστός
bark	ο φλοιός
army	ο στρατός
panic	ο πανικός
to settle	εγκαθιστώ
to inhabit	κατοικώ
to threaten	απειλώ
to sound	ηχώ
to provoke	προκαλώ
to meet	συναντώ
to forgive	συγχωρώ
to suck	ρουφώ
to act	ενεργώ
to swim	κολυμπώ
forest	το δάσος
egg	το αυγό
bread	το ψωμί
box	το κουτί
light	το φώς
minute	το λεπτό
gold	το χρυσό
courage	το θάρρος
dinner	το βραδινό
interest	το ενδιαφέρον
where	πού
well	καλά
still	ακόμα
never	ποτέ
very	πολύ
twenty	είκοσι
so	έτσι
yes	ναι
until	μέχρι
near	κοντά
staple	ο συνδετήρας
parent	ο γονέας
stirrup	ο αναβολέας
flatterer	ο κόλακας
kettle	ο βραστήρας
rampart	ο προμαχώνας
cloak	ο μανδύας
century	ο αιώνας
hero	ο ήρωας
searchlight	ο προβολέας
to swear	βρίζω
to close	κλείνω
to break	σπάζω
to save	σώζω
to forbid	απαγορεύω
to wash	πλένω
to travel	ταξιδεύω
to bring	φέρνω
to doubt	αμφιβάλλω
to return	επιστρέφω
measles	η ιλαρά
attitude	η συμπεριφορά
niece	η ανηψιά
fist	η γροθιά
footprint	η πατημασιά
filth	η βρωμιά
lilac	η πασχαλιά
belly	η κοιλιά
cave	η σπηλιά
landlady	η σπιτονοικοκυρά
remunerative	αποδοτικός
polished	στιλπνός
contagious	μεταδοτικός
despotic	δεσποτικός
defiant	προκλητικός
verminous	παρασιτικός
restful	αναπαυτικός
homely	σπιτικός
commonplace	κοινός
chalky	κρητιδικός
foreigner	ο ξένος
law	ο νόμος
wolf	ο λύκος
master	ο κύριος
cuckoo	ο κούκος
policeman	ο αστυνόμος
partner	ο συνέταιρος
uproar	ο σάλος
manner	ο τρόπος
haddock	ο γάδος
to honour	τιμώ
to invite	προσκαλώ
to measure	μετρώ
to spoil	χαλώ
to hail	χαιρετώ
to chasten	τιμωρώ
to awake	ξυπνώ
to warn	προειδοποιώ
to consider	θεωρώ
to bless	ευλογώ
boy	το αγόρι
glass	το ποτήρι
soap	το σαπούνι
vinegar	το ξύδι
eyebrow	το φρύδι
leg	το πόδι
game	το παιχνίδι
tooth	το δόντι
river	το ποτάμι
hat	το καππέλο
long	μακρύς
one	ένας
also	επίσης
perhaps	ίσως
heavy	βαρύς
light	ελαφρύς
thick	παχύς
yesterday	χθες
immediately	αμέσως
evidently	προφανώς
painter	ο βάφτης
ruler	ο κυβερνήτης
bachelor	ο εργένης
benefactor	ο ευεργέτης
grumbler	ο γκρινιάρης
welder	ο οξυγονοκολλητής
fugitive	ο φυγάς
collector	ο συλλέκτης
customer	ο πελάτης
advertiser	ο διαφημιστής
to hide	κρύβω
to continue	συνεχίζω
to bend	σκύβω
to bite	δαγκώνω
to pack	πακετάρω
to propose	προτείνω
to astonish	εκπλήσσω
to kill	σκοτώνω
to repeat	επαναλαμβάνω
to sign	υπογράφω
music	η μυσική
scene	η σκηνή
machine	η μηχανή
roof	ηοροφή
beach	η ακτή
life	η ζωή
rage	η οργή
soul	η ψυχή
prison	η φυλακή
cry	η κραυγή
proud	υπερήφανος
excellent	άριστος
rare	σπάνιος
weak	αδύναμος
pure	ατόφιος
miserable	δυστυχισμένος
just	δίκαιος
beautiful	όμορφος
honest	τίμιος
immediate	άμεσος
thigh	ομηρός
grandson	ο εγγονός
appointment	οδιορισμός
lark	ο κορυδαλλός
sigh	ο αναστεναγμός
station	ο σταθμός
rank	ο βαθμός
hunter	ο κυνηγός
shot	οπυροβολισμός
reviewer	ο κριτικός
to wear	φορώ
to glide	γλιστρώ
to knock	χτυπώ
to rush	ορμώ
to inform	πληροφορώ
to set	τοποθετώ
to surpass	ξεπερνώ
to owe	χρωστώ
to praise	επαινώ
to gladden	ευχαριστώ
floor	το πάτωμα
wave	το κύμα
skin	το δέρμα
sunset	το ηλιοβασίλεμα
blood	το αίμα
accident	το ατύχημα
lie	το ψέμα
example	το παράδειγμα
occupation	το επάγγελμα
sentiment	το αίσθημα
why	γιατί
blue	μπλε
already	ήδη
here	εδώ
almost	σχεδόν
now	τώρα
with	μαζί
enough	αρκετά
often	συχνά
late	αργά
chef	ο μάγειρας
basin	ο νιπτήρας
dipper	ο νεροκότσυφας
perspiration	ο ίδρωτας
suitor	ο μνηστήρας
dictator	ο δικτάτορας
character	ο χαρακτήρας
pope	ο πάπας
orator	ο ρήτωρας
pulpit	ο άμβωνας
to add	προσθέτω
to move	μετακομίζω
to arrange	κανονίζω
to recognize	αναγνωρίζω
to spend	ξοδεύω
to conduct	διεξάγω
to send	στέλνω
to prove	αποδεικνύω
to breathe	αναπνέω
to persuade	πείθω
week	η εβδομάδα
stone	η πέτρα
work	η εργασία
newspaper	η εφιμερίδα
truth	η αλήθεια
chance	η ευκαιρία
route	η πορεία
kitchen	η κουζίνα
curtain	η κουρτίνα
staircase	η σκάλα
fleecy	μαλλιαρός
editorial	εκδοτικός
stifling	αποπνικτικός
jagged	οδοντωτός
deniable	αρνητικός
antiquarian	αρχαιολογικός
oriental	ανατολικός
plump	παχουλός
affirmative	καταφατικός
adverbial	επιρρηαμτικός
lawyer	ο δικηγόρος
hill	ο λόφος
widower	ο χήρος
angel	ο άγγελος
oath	ο όρκος
devil	ο διάβολος
sound	ο ήχος
nap	ο υπνάκος
crag	ο βράχος
consul	ο πρόξενος
to disturb	ενοχλώ
to mark	βαθμολογώ
to deprive	στερώ
to obtain	αποκτώ
to displease	δυσαρεστώ
to prompt	παρακινώ
to confess	ομολογώ
to direct	καθοδηγώ
to acquire	αποκτώ
to curse	βλαστημώ
train	το τρένο
apple	το μήλο
airplane	το αεροπλάνο
ship	το πλοίο
smile	το χαμόγελο
ticket	το εισιτήριο
shirt	το πουκάμισο
dream	το όνειρο
autumn	το φθινόπωρο
shoe	το παπούτσι
otherwise	αλλιώς
deep	βαθύς
blunt	αμβλύς
broad	φαρδύς
early	νωρίς
four	τέσσερις
precise	ακριβής
noble	ευγενής
orange	πορτοακλής
jealous	ζηλιάρης
employer	ο εργοδότης
seaman	ο ναύτης
giver	ο δωρητής
liar	ο ψεύτης
weaver	ο υφαντής
priest	ο παπάς
overseer	ο επιστάτης
sharpener	ο ξύστης
pickpocket	ο πορτοφολάς
climber	ο ορειβάτης
to weigh	ζυγίζω
to obey	υπακούω
to cover	καλύπτω
to deepen	βαθαίνω
to occupy	καταλαμβάνω
to endure	αντέχω
to beg	ζητιανεύω
to lend	δανείζω
to cook	μαγειρεύω
to dance	χορεύω
visit	η επίσκεψη
memory	η μνήμη
library	η βιβλιοθήκη
arrival	η άφιξη
taste	η γεύση
proof	η απόδειξη
sugar	η ζάχαρη
phrase	η φράση
order	η τάξη
nature	η φύση
rich	πλούσιος
calm	ήρεμος
third	τρίτος
ridiculous	γελοίος
busy	απασχολημένος
wonderful	θαυμάσιος
elder	μεγαλύτερος
hollow	κούφιος
first	πρώτος
equal	ίσος
frost	ο παγετός
cliff	ο γκρεμός
musician	ο μουσικός
thunder	ο κεραυνός
hare	ο λαγός
wrist	ο καρπός
pheasant	ο φασιανός
admiration	ο θαυμασμός
coward	ο δειλός
equipment	ο εξοπλισμός
to mean	εννοώ
to pierce	διατρυπώ
to chastise	τιμωρώ
to slip	γλιστρώ
to summon	καλώ
to treat	κερνώ
to harass	παρενοχλώ
to beseech	εκλιπαρώ
to investigate	εξερευνώ
to attempt	προσπαθώ
bacon	το μπέικον
pork	το χοιρινό
coat	το παλτό
lamb	το αρνί
shop	το μαγαζί
part	το μέρος
lunch	το μεσημεριανό
tear	το δάκρυ
ear	το αυτί
food	το φαγητό
far	μακριά
quickly	γρήγορα
finally	τελικά
only	μόνο
brown	καφέ
together	μαζί
truly	αλήθεια
today	σήμερα
slowly	αργά
suddenly	ξαφνικά
pianist	ο πιανίστας
palm	ο φοίνικας
ramrod	ο εμβολέας
contest	ο αγώνας
splint	ο νάρθηκας
emperor	ο αυτοκράτορας
prairie	ο λειμώνας
adult	ο ενήλικας
fan	ο ανεμιστήρας
race	ο αγώνας
to permit	επιτρέπω
to sew	ράβω
to prepare	προετοιμάζω
to earn	κερδίζω
to flatten	ισοπεδώνω
to accompany	συνοδεύω
to steal	κλέβω
to abandon	εγκαταλείπω
to dine	γευματίζω
to heal	επουλώνω
viper	η οχιά
beauty	η ομορφιά
dirt	η βρωμιά
tail	η ουρά
rust	η σκουριά
offer	η προσφορά
turn	η σειρά
lair	η φωλιά
firefly	η κωλοφωτιά
apron	η ποδιά
academical	ακαδημαϊκός
accessory	συμπληρωματικός
complimentary	φιλοφρονητικός
enjoyable	απολαυστικός
demure	σεμνός
bothersome	ενοχλητικός
thickset	πυκνός
contemplative	στοχαστικός
greenish	πρασινωπός
hoary	πολιός
brush	ο θάμνος
hook	ο γάντζος
tomb	ο τάφος
title	ο τίτλος
musk	ομόσχος
opponent	ο αντίπαλος
philosopher	οφιλόσοφος
tone	ο τόνος
mill	ο μύλος
lizard	ο σαύρος
to detain	κρατώ
to observe	παρατηρώ
to clap	χειροκροτώ
to besiege	πολιορκώ
to inherit	κληρονομώ
to create	δημιουργώ
to agree	συμφωνώ
to employ	εργοδοτώ
to satisfy	ικανοποιώ
to proceed	προχωρώ
fork	το πηρούνι
watch	το ρολόι
hail	το χαλάζι
colt	το πουλάρι
calf	το μοσχάρι
oil	το λάδι
lip	το χείλι
purse	το πορτοφόλι
rabbit	το κουνέλι
dish	το πιάτο
mysterious	μηστεριώδης
thirteen	δεκατρείς
totally	εντελώς
rough	τραχύς
fourteen	δεκατέσερρις
entirely	εντελώς
extraordinary	ασυνήθης
healthy	υγιής
rude	αγενής
exact	ακριβής
host	ο οικοδεσπότης
viscount	ο υποκόμης
traveller	ο ταξιδιώτης
hijacker	ο αεροπειρατής
feeder	ο τροφοδότης
conspirator	ο συνωμότης
hinge	ο μεντεσές
violet	ο μενεξές
glutton	ο φαγάς
speaker	ο ομιλητής
to amuse	διασκεδάζω
to load	φορτώνω
to turn	στρίβω
to prevent	εμποδίζω
to sweeten	γλυκαίνω
to furnish	επιπλώνω
to flee	καταφεύγω
to tend	τείνω
to rain	βρέχω
to touch	αγγίζω
oak	η δρύς
prayer	η προσευχή
sand	η άμμος
coast	η ακτή
breath	η αναπνοή
dawn	η αυγή
hoof	η οπλή
wish	η ευχή
payment	η πληρωμή
advice	η συμβουλή
pretty	χαριτωμένος
unable	ανίκανος
useless	άχρηστος
fragile	εύθραστος
nice	ωραίος
monotonous	μονότονος
spontaneous	αυθόρμητος
stiff	αλύγιστος
next	επόμενος
violent	βίαιος
crowbar	ο λοστός
heaven	ο ουρανός
specialist	ο ειδικός
nephew	ο ανηψιός
partnership	ο συνεταιρισμός
believer	ο πιστός
camp	ο καταυλισμός
enticement	ο δελεασμός
creator	ο δημιουργός
fever	ο πυρετός
to come	έρχομαι
to think	σκέπτομαι
to feel	αισθάνομαι
to become	γίνομαι
to sit	κάθομαι
to appear	εμφανίζομαι
to disappear	εξαφανίζομαι
to marry	παντρεύομαι
to dress	ντύνομαι
to imagine	φαντάζομαι
space	το διάστημα
welcome	το καλωσόρισμα
color	το χρώμα
lesson	το μάθημα
ghost	το φάντασμα
scaffold	το ικρίωμα
spectacle	το θέαμα
apartment	το διαμέρισμα
bet	το στοίχημα
poem	το ποιήμα
tomorrow	αύριο
everywhere	παντού
really	πραγματικά
out	έξω
soon	σύντομα
carefully	προσεκτικά
five	πέντε
up	πάνω
six	έξι
naturally	φυσικά
struggle	ο αγώνας
carrier	ο μεταφορέας
giant	ο γίγαντας
sweat	ο ίδρωτας
sinew	ο τένοντας
herald	ο κήρυκας
spray	ο ψεκαστήρας
tourist	ο τουρίστας
ape	ο πίθηκας
axis	ο αξώνας
to gratify	ικανοποιώ
to repent	μετανοώ
to sustain	συγκρατώ
to grieve	θρηνώ
to dash	ορμώ
to overcome	ξεπερνώ
to beget	γεννώ
to venture	αποτολμώ
to conquer	κατακτώ
to overtake	προσπερνώ
image	η εικόνα
chair	η καρέκλα
corner	η γωνία
lamp	η λάμπα
church	η εκκλησία
friendship	η φιλία
lady	η κυρία
hope	η ελπίδα
service	η υπηρεσία
bath	η μπανιέρα
presidential	προεδρικός
flashy	φανταχτερός
voluble	ομιλητικός
manifold	πολλαπλός
aristocratic	αριστοκρατικός
auxiliary	βοηθητικός
effective	αποτελεσματικός
decorative	διακοσμητικός
animal	ζωικός
preventive	προληπτικός
brain	ο εγκέφαλος
accomplice	ο σύνεργος
rock	ο βράχος
steward	ο θαλαμηπόλος
swan	ο κύκνος
unbeliever	ο άπιστος
railroad	οσιδηρόδρομος
grave	ο τάφος
moth	ο σκώρος
slime	οβούρκος
to sleep	κοιμάμαι
to recount	αφηγούμαι
to refuse	αρνούμαι
to remember	θυμάμαι
to fear	φοβάμαι
to regret	λυπάμαι
to deny	αρνούμαι
to undergo	υφίσταμαι
to wander	περιπλανούμαι
to roar	βρύχωμαι
butter	το βούτηρο
park	το πάρκο
cheek	το μάγουλο
plate	το πιάτο
laugh	το γέλιο
sheep	το πρόβατο
university	το πανεπιστήμιο
forehead	το μέτωπο
bedroom	το υπνοδωμάτιο
harbour	το λιμάνι
evident	προφανής
ignoble	αναξιοπρεπής
joyful	περιχαρής
lazy	τεμπέλης
thoroughly	εντελώς
much	πολύς
likewise	ομοίως
brutal	κτηνώδης
transparent	διαφανής
three	τρείς
champion	ο πρωταθλητής
nomad	ο νομάς
drunkard	ο μπεκρής
pupil	ο μαθητής
liberator	ο απελευθερωτής
indicator	ο δείκτης
buyer	ο αγοραστής
hypocrite	ο υποκριτής
thief	ο κλέφτης
palfrey	ο κέλης
to listen	ακούω
to happen	συμβαίνω
to admire	θαυμάζω
to declare	δηλώνω
to approve	εγκρίνω
to let	αφήνω
to freeze	παγώνω
to mock	κοροιδεύω
to darken	σκοτεινιάζω
to differ	διαφέρω
impression	η εντύπωση
city	η πόλη
spring	η άνοιξη
expression	η έκφραση
movement	η κίνηση
heat	η ζέστη
pocket	η τσέπη
peace	η ειρήνη
luck	η τύχη
sadness	η λύπη
suspicious	ύποπτος
worthy	άξιος
superb	υπέροχος
plentiful	άφθονος
naive	μωρόπιστος
foolish	ανόητος
nervous	ανήσυχος
unbearable	αφόρητος
clumsy	αδέξιος
ill	άρρωστος
pace	ορυθμός
officer	ο αξιοματικός
fool	ο χαζός
flea	ο ψυλλός
kite	ο χαρταετός
nullification	ο μηδενισμός
peacemaker	ο ειρηνοποιός
torch	ο φακός
enemy	ο εχθρός
eagle	ο αετός
to work	εργάζομαι
to rejoice	χαίρομαι
to accept	δέχομαι
to shave	ξυρίζομαι
to rely	βασίζομαι
to seem	φαίνομαι
to wish	εύχομαι
to promise	υπόσχομαι
to admit	παραδέχομαι
to swell	πρήζομαι
garage	το γκαράζ
bird	το πουλί
bathroom	το λουτρό
paper	το χαρτί
weight	το βάρος
rug	το χαλί
crowd	το πλήθος
village	το χωριό
husk	το κέλυφος
land	το έδαφος
probably	μάλλον
willingly	πρόθυμα
afterward	μετά
surely	σίγουρα
moreover	επιπλέον
equally	εξίσου
eight	οκτώ
regularly	τακτικά
grateful	ευγνώμων
nevertheless	ωστόσο
hairdresser	ο κομμωτής
tenant	ο ενοικαστής
announcer	ο εκφωνητής
magistrate	ο δικαστής
potter	ο αγγειοπλάστης
patron	ο προστάτης
worker	ο εργάτης
tramp	ο αλήτης
doer	ο δράστης
harvester	ο θεριστής
to crave	λαχταρώ
to value	εκτιμώ
to chase	κυνηγώ
to remove	αφαιρώ
to deem	θεωρώ
to drag	τραβώ
to hurl	πετώ
to grant	χορηγώ
to chew	μασώ
to vex	ενοχλώ
damage	η ζημιά
burrow	η φωλιά
conduct	η συμπεριφορά
task	η δουλειά
manure	η κοπριά
laziness	η τεμπελιά
purchase	η αγορά
solitude	η μοναξιά
sequence	η σειρά
beech	η οξιά
fleshly	σωματικός
frowning	σκυθρωπός
hoarse	βραχνός
pressing	πιεστικός
vestigial	υπολειμματικός
persuasive	πειστικός
resourceful	επινοητικός
doctrinal	δογματικός
demanding	απαιτητικός
communist	κομουνιστικός
cap	ο σκούφος
danger	ο κίνδυνος
juror	ο ένορκος
hostage	οόμηρος
prisoner	ο φυλακισόμενος
chaos	ο χάος
marquis	ο μαρκήσιος
printer	ο τυπογράφος
bishop	ο επίσκοπος
habitat	ο βιότοπος
to oversleep	παρακοιμάμαι
to resign	παραιτούμαι
to quit	παραιτούμαι
to imitate	μιμούμαι
to roam	περιπλανιέμαι
to depend	εξαρτιέμαι
to wonder	αναρωτιέμαι
to complain	παραπονιέμαι
to boast	καυχιέμαι
to attack	επιτίθεμαι
pillow	το μαξιλάρι
lemon	το λεμόνι
summer	το καλοκαίρι
orange	το πορτοκάλι
stomach	το στομάχι
piece	το κομμάτι
cherry	το κεράσι
cupboard	το ντουλάπι
corn	το καλαμπόκι
marble	το μάρμαρο
fortunate	ευτυχής
without	χωρίς
wide	φαρδύς
continuous	συνεχής
habitual	συνήθης
none	κανένας
direct	ευθύς
modest	μετριόφρονας
constant	συνεχής
perpetual	διαρκής
argument	ο καβγάς
sponsor	ο εγγυητής
robber	ο ληστής
carver	ο γλύπτης
count	ο κόμης
sportsman	ο αθλητής
passenger	ο επιβάτης
blunderer	ο ατζαμής
scraper	ο ξύστης
senator	ο γερουσιαστής
to get	παίρνω
to grind	αλέθω
to melt	λιώνω
to advertise	διαφημίζω
to smell	μυρίζω
to immigrate	μεταναστεύω
to disapprove	αποδοκιμάζω
to mend	επισκευάζω
to avoid	αποφεύγω
to quote	αναφέρω
robe	η τήβεννος
harvest	η συγκομιδή
shame	η ντροπή
line	η γραμμή
collection	η συλλογή
nun	η μοναχή
entrance	η είσοδος
fox	η αλεπού
copy	η αντιγραφή
attention	η προσοχή
fifth	πέμπτος
graceful	χαριτωμένος
timid	άτολμος
dreadful	απαίσιος
essential	απαραίτητος
haughty	αγέρωχος
shabby	ξεφτισμένος
someone	κάποιος
intelligent	έξυπνος
ripe	ώριμος
bug	οκοριός
portent	ο οιωνός
monk	ο μοναχός
scorpion	ο σκορπιός
equator	ο ισημερινός
crucifix	ο σταυρός
dance	οχορός
tourism	οτουρισμός
bedbug	οκοριός
psalm	ο ψαλμός
to defend	υπερασπίζομαι
to require	χρειάζομαι
to sink	βυθίζομαι
to bathe	λούζομαι
to pray	προσεύχομαι
to assemble	συγκεντρώνομαι
to stand	στέκομαι
to lie	ψεύδομαι
to resist	αντιστέκομαι
to undress	ξεντύνομαι
material	το ύφασμα
problem	το πρόβλημα
bedspread	το πάπλωμα
chariot	το άρμα
marvel	το θαύμα
stroke	το χτύπημα
step	το βήμα
fossil	το απολίθωμα
overflow	το ξεχείλισμα
shape	το σχήμα
fifty	πενήντα
from	από
because	γιατί
pink	ρόζ
seven	επτά
eighty	ογδόντα
personally	προσωπικά
ninety	ενενήντα
nine	εννέα
forty	σαράντα
inventor	ο εφευρέτης
researcher	ο ερευνητής
auctioneer	ο δημοπράτης
traitor	ο προδότης
nuisance	ο μπελάς
planner	ο σχεδιαστής
advocate	ο υποστηρικτής
consumer	ο καταναλωτής
magnet	ο μαγνήτης
bungler	ο ατζαμής
to languish	ατονώ
to dispossess	στερώ
to yield	παραχωρώ
to despise	περιφρονώ
to shake	κουνώ
to trample	ποδοπατώ
to favour	ευνοώ
to ail	ταλαιπωρώ
to migrate	αποδημώ
to bequeath	κληροδοτώ
page	η σελίδα
hole	η τρύπα
aunt	η θεία
boat	η βάρκα
speed	η ταχύτητα
happiness	η ευτυχία
goose	η χήνα
queen	η βασίλισσα
comb	η χτένα
tongue	η γλώσσα
rotary	περιστροφικός
taught	διδακτός
ablative	αφαιρετικός
catchy	ελκυστικός
stereophonic	στερεοφωνικός
engaging	θελκτικός
resilient	ανθεκτικός
sneaky	πονηρός
predatory	αρπακτικός
stellar	αστρικός
fright	οφόβος
pier	ο μώλος
murder	οφόνος
dew	οδρόσος
gentleman	ο κύριος
control	ο έλεγχος
type	ο τύπος
squirrel	οσκίουρος
accuser	ο κατήγορος
advisor	οσύμβουλος
to disavow	απαρνούμαι
to pretend	προσποιούμαι
to oppose	αντιτίθεμαι
to equal	εξισωνόμαι
to recollect	θυμάμαι
to explode	εκρηγνυμαι
to avenge	εκδικούμαι
to narrate	αφηγούμαι
to scramble	αναρριχιέμαι
to stratify	στρωματοποιούμαι
second	το δευτερόλεπτο
front	το μέτωπο
sausage	το λουκάνικο
plan	το σχέδιο
ashtray	το σταχτοδοχέιο
pattern	το σχέδιο
stamp	το γραμματόσημο
vase	το βάζο
object	το αντικείμενο
basket	το καλάθι
luxurious	πολυτελής
sincere	ειληκρινής
adequate	επαρκής
imperfect	ατελής
disrespectful	ασεβής
ordinarily	συνήθως
prompt	ταχύς
courtly	ευγενής
however	όμως
safe	ασφαλής
peasant	ο χωριάτης
caretaker	ο επιστάτης
commentator	ο σχολιαστής
landlord	ο σπιτονοικοκύρης
player	ο παίχτης
hunchback	ο καμπούρης
nobleman	ο αριστοκράτης
fisherman	ο ψαράς
transformer	ο μετασχηματιστή
creditor	ο πιστωτής
to grumble	γκρινιάζω
to allure	δελεάζω
to reach	φθάνω
to test	ελέγχω
to hurt	πληγώνω
to complete	συμπληρώνω
to pale	χλωμιάζω
to produce	παράγω
to bow	υποκλίνω
to determine	καθορίζω
distance	η απόσταση
edge	η άκρη
meeting	η συνάντηση
departure	η αναχώρηση
surprise	η έκπληξη
assurance	η βεβαίωση
dust	η σκόνη
refusal	η άρνηση
examination	η εξέταση
hell	η κόλαση
feeble	αδύναμος
fourth	τέταρτος
extreme	ακραίος
complete	ολόκληρος
endless	ατελείωτος
furious	εξοργισμένος
uncertain	αβέβαιος
marvelous	θαυμάσιος
drunk	μεθυσμένος
sinister	δόλιος
crane	ο γερανός
smoke	ο καπνός
reckoning	ο υπολογισμός
lobster	ο αστακός
clay	ο πηλός
reverence	ο σεβασμός
point	ο βαθμός
inundation	ο κατακλυσμός
persecution	ο διωγμός
celebration	ο εορτασμός
to attend	παραβρίσκομαι
to trust	εμπιστεύομαι
to rest	ξεκουράζομαι
to improve	βελτιώνομαι
to borrow	δανείζομαι
to entrust	εμπιστεύομαι
to deign	καταδέχομαι
to rise	σηκώνομαι
to mistreat	ακομεταχειρίζομαι
to suspect	υποψιάζομαι
hammer	το σφυρί
flesh	το κρέας
width	το φάρδος
height	το ύψος
candle	το κερί
baby	το μωρό
strap	το λουρί
branch	το κλαδί
burden	το βάρος
bar	το μπαρ
sixty	εξήντα
ten	δέκα
thirty	τριάντα
after	μετά
actually	πραγματικά
two	δύο
eleven	ένδεκα
sixteen	δεκαέξι
purple	βυσσινί
eighteen	δεκοκτώ
bricklayer	ο πλινθοκτίστης
spot	ο λεκές
bucket	ο κουβάς
wretch	ο φουκαράς
doorpost	ο παραστάτης
monopolist	ο μονοπωλητής
plasterer	ο σοβατζής
spinner	ο κλώστης
compositor	ο στοιχειοθέτης
waterfall	ο καταράκτης
to abound	αφθονώ
to maintain	διατηρώ
to conspire	συνωμοτώ
to prefer	προτιμώ
to laud	επαινώ
to chart	χαρτογραφώ
to incite	υποκινώ
to disobey	απειθώ
to adopt	υιοθετώ
to dishonor	ατιμώ
report	η αναφορά
delight	η χαρά
shade	η σκιά
meadow	η λειβαδιά
draught	η γουλιά
anthill	η μυρμηγκοφωλιά
corruption	η διαφθορά
lock	η κλειδαριά
scratch	η γρατσουνιά
odor	η μυρωδιά
vapid	ανιαρός
flamboyant	φανταχτερός
endearing	ελκυστικός
optical	οπτικός
fancied	φανταστικός
philanthropic	φιλανθρωπικός
noncommittal	επιφυλακτικός
galling	πικρός
harmonious	αρμονικός
cloven	διχαλωτός
furnace	οφούρνος
barrister	ο συνήγορος
loser	ο χαμένος
heir	ο κληρονόμος
surveyor	ο τοπογράφος
ankle	ο αστράγαλος
pit	ο λάκκος
exertion	ο κόπος
ancestor	ο πρόγονος
fellow	ο τύπος
to misuse	καταχρώμαι
to precede	προηγούμαι
to doze	λαγοκοιμάμαι
to relate	διηγούμαι
to drowse	μισοκοιμάμαι
to rove	περιπλανιέμαι
to vouch	εγγυώμαι
to petition	αιτούμαι
to consist	αποτελούμαι
to stray	περιπλανιέμαι
clock	το ρολόι
spoon	το κουτάλι
snake	το φίδι
lion	το λιοντάρι
salt	το αλάτι
voyage	το ταξίδι
silver	το ασήμι
moon	το φεγγάρι
field	το χωράφι
person	το άτομο
unsafe	ανασφαλής
lightly	ελαφρώς
forgetful	ξεχασιάρης
consequently	επομένως
fortunately	ευτυχώς
formerly	τέως
widely	ευρέως
slightly	ελαφρώς
grand	μεγαλοπρεπής
usually	συνήθως
translator	ο μεταφραστής
earl	ο κόμης
spiritualist	ο πνευματιστής
beholder	ο θεατής
swimmer	ο κολυμβητής
agitator	ο υποκινητής
colonel	ο συνταγματάρχη
grower	ο καλλιεργητής
harpist	ο αρπιστής
censor	ο λογοκρίτης
to humble	ταπεινώνω
to develop	αναπτύσσω
to bury	θάβω
to lay	βάζω
to teach	διδάσκω
to oblige	υποχρεώνω
to fit	ταιριάζω
to demolish	κατεδαφίζω
to drip	στάζω
to stiffen	σκληραίνω
sore	η πληγή
peak	η κορυφή
slaughter	η σφαγή
motor	η μηχανή
admission	η εισαγωγή
seam	η ραφή
wrath	η οργή
caution	η προσοχή
mainland	η ηπειρωτική
advancement	η πρόοδος
greedy	λαίμαργος
angry	θυμωμένος
spacious	ευρύχωρος
abnormal	ανώμαλος
disagreeable	δυσάρεστος
fearful	φοβίσμενος
precious	πολύτιμος
dishonest	άτιμος
docile	πειθήνιος
absurd	παράλογος
claim	οισχυρισμός
helper	οβοηθός
rheumatism	ο ρευμαστισμός
carpenter	ο μαραγκός
skeleton	ο σκελετός
sinner	ο αμαρτωλός
conjurer	ταχυδακτυλουργό
irritation	ο εκνευρισμός
bridegroom	ο γαμπρός
surgeon	ο χειρουργός
to relax	ξεκουράζομαι
to ponder	συλλογίζομαι
to revere	σέβομαι
to strive	αγωνίζομαι
to vow	ορκίζομαι
to mingle	αναμιγνύομαι
to confide	εμπιστεύομαι
to disembark	αποβιβάζομαι
to waver	ταλαντεύομαι
to specialize	ειδικεύομαι
right	το δικαίωμα
gratuity	το φιλοδώρημα
artifice	το τέχνασμα
meal	το γεύμα
jump	το πήδημα
nothing	το τίποτα
sermon	το κήρυγμα
decree	το διάταγμα
bite	το δάγκωμα
falsehood	το ψέμα
even	ακόμα
absent	απών
twelve	δώδεκα
visibly	φανερά
some	μερικοί
always	πάντα
against	εναντίον
rarely	σπάνια
nineteen	δεκαεννέα
generally	γενικά
pretender	ο διεκδικητής
publisher	ο εκδώτης
fireman	ο πυροσβέστης
sprinkler	ο ψεκαστής
tailor	ο ράφτης
healer	ο θεραπευτής
hurricane	ο τυφώνας
treasurer	ο ταμίας
ether	ο αιθέρας
tusk	ο χαυλιόδοντας
to standardize	τυποποιώ
to resound	αντηχώ
to scorn	περιφρονώ
to glitter	σπινθηροβολώ
to underrate	υποτιμώ
to faint	λιποθυμώ
to entreat	παρακαλώ
to accuse	κατηγορώ
to resuscitate	αναζωογονώ
to distrust	δυσπιστώ
storm	η θύελλα
bear	η αρκούδα
skirt	η φούστα
necktie	η γραβάτα
success	η επιτυχία
cat	η γάτα
charm	η γοητεία
health	η υγεία
sock	η κάλτσα
permission	η άδεια
sultry	αποπνικτικός
sporadic	σποραδικός
binding	δεσμευτικός
dreary	μελανγχολικός
cumulative	σωρευτικός
burdensome	φορτικός
surprising	εκπληκτικός
bent	κυρτός
toothed	οδοντωτός
sullen	σκυθρωπός
mound	ο λοφίσκος
wart	ο σπίλος
inhabitant	ο κάτοικος
scholar	ο λόγιος
catalogue	ο κατάλογος
suffering	ο πόνος
snuff	ο ταμπάκος
wizard	ο μάγος
way	ο τρόπος
tyrant	ο τύραννος
to appropriate	ιδιοποιούμαι
to flinch	τραβιέμαι
to hover	αιωρούμαι
to bestir	κινούμαι
to impersonate	απομιμούμαι
to forego	προηγούμαι
to simulate	απομιμούμαι
to abdicate	παραιτούμαι
to conjure	επικαλούμαι
to ape	μιμούμαι
limit	τοόριο
churchyard	το νεκροταφείο
stadium	το στάδιο
inn	το πανδοχείο
animal	το ζώο
furniture	το έπιπλο
million	το εκαταμύρριο
film	το έργο
weekend	ο σαββατοκύριακ
border	τοσύνορο
fully	πλήρως
frank	ειλικρινής
accurate	ακριβής
maybe	ίσως
mean	τσιγγούνης
secure	ασφαλής
unstable	ασταθής
idle	τεμπέλης
publicly	δημοσίως
trustworthy	αψιίπιστοσ
flotilla	ο στολίσκος
hedgehog	ο σκαντζόχοιρος
beggar	ο ζητιάνος
vow	ο όρκος
newcomer	ο νεοφερόμενος
attacker	ο επιτιθέμενος
mercenary	ομισθοφόρος
rival	ο αντίζηλος
tower	ο πύργος
sponge	ο σπόγγος
to fade	χεθωριάζω
to announce	ανακοινώνω
to pick	διαλέγω
to exist	υπάρχω
to clean	καθορίζω
to cough	βήχω
to shut	κλείνω
to separate	χωρίζω
to tear	σχίζω
to insist	επιμένω
flight	η πτήση
approach	η προσέγγιση
rest	η ξεκούραση
fight	η μάχη
extent	η έκταση
lack	η έλλειψη
training	η προπόνηση
drunkenness	η μέθη
trickery	η απάτη
trial	η δίκη
unexpected	απροσδόκητος
tired	κουρασμένος
principal	κύριος
diverse	ποικίλος
eternal	αιώνιος
indifferent	αδιάφορος
barbarous	βάρβαρος
naughty	άτακτος
vast	τεράστιος
infinite	απέραντος
miscreant	ο αχρείος
cod	ο μπακαλιάρος
dome	ο τρούλος
hillock	ο λοφίσκος
settler	ο άποικος
suspect	ο ύποπτος
courier	ο αγγελιαφόρος
lover	ο ερωμένος
knob	ο κόμπος
knot	ο κόμπος
to enrol	εγγράφομαι
to shrink	συρρικνώνομαι
to recline	ανακλίνομαι
to atone	εξιλεώνομαι
to confer	συσκέπτομαι
to vanish	εξαφανίζομαι
to claim	ισχυρίζομαι
to retire	αποστρατυεύομαι
to hurry	βιάζομαι
to revert	επανέρχομαι
cage	το κλουβί
wax	το κερί
key	το κλειδί
vessel	το σκεύος
navy	το ναυτικό
mountain	το βουνό
slate	το σχιστόλιθος
boldness	το θάρρος
mercy	το έλεος
wing	το φτερό
seventy	εβδομήντα
seventeen	δεκαεπτά
fifteen	δεκαπέντε
few	λίγοι
normally	φυσιολογικά
above	πάνω
interesting	ενδιαφέρων
ever	ποτέ
silently	σιωπηλά
shortly	σύντομα
string	ο σπάγγος
journalist	ο δημοσιογράφος
ostrich	ο στρουθοκάμηλος
bull	ο ταύρος
council	ο δήμος
vandal	ο βάνδαλος
rat	ο αρουραίος
envy	ο φθόνος
bench	ο πάγκος
record	ο δίσκος
to rank	ταξινομώ
to kiss	φιλώ
to vanquish	κατανικώ
to thunder	βροντώ
to subside	υποχωρώ
to classify	ταξινομώ
to pester	ενοχλώ
to embarrass	στενοχωρώ
to swing	κουνώ
to hit	χτυπώ
habit	η συνήθεια
help	η βοήθεια
cow	η αγελάδα
acquaintance	η γνωριμία
company	η εταιρία
wasp	η σφήκα
date	η ημερομηνία
umbrella	η ομπρέλα
potato	η πατάτα
broom	η σκούπα
antic	κωμικός
pharmacological	φαρμακολογικός
clotted	πηχτός
harmonic	αρμονικός
offensive	προσβλητικός
fluid	ρευστός
obvious	φανερός
relative	συγγενικός
wintry	χειμερινός
unconstitutional	ντισυνταγματικός
bush	ο θάμνος
parrot	ο παππαγάλος
wedding	ο γάμος
lighthouse	ο φάρος
stucco	ο στόκος
tadpole	ο γυρίνος
ulcer	ο έλκος
stranger	ο ξένος
pleader	ο συνήγορος
rhinoceros	ο ρινόκερος
to intermingle	αναμιγνύομαι
to compete	συναγωνίζομαι
to perceive	αντιλαμβάνομαι
to jostle	σπρώχνομαι
to entwine	περιελίσσομαι
to contend	διατείνομαι
to devise	μηχανεύομαι
to gyrate	περιστρέφομαι
to skimp	τσιγγουνεύομαι
to collide	συγκρούομαι
ink	το μελάνι
grass	το γρασίδι
snow	το χιόνι
kitten	το γατάκι
glove	το γάντι
flower	το λουλούδι
couple	το ζευγάρι
chin	το πηγούνι
deer	το ελάφι
scissors	το ψαλίδι
stingy	τσιγγούνης
stringy	ινώδης
craggy	κρημνώδης
forthwith	αμέσως
profitable	επικερδής
chaotic	χαώδης
utterly	εντελώς
stubborn	πεισματάρης
boisterous	θορυβώδης
foamy	αφρώδης
envelope	ο φάκελος
lust	ο πόθος
puddle	ο νερόλακκος
predecessor	ο προκάτοχος
clothier	ο υφασματεμπόρος
veil	ο πέπλος
aggressor	ο επιτιθέμενος
elector	οψηφοφόρος
triumph	ο θρίαμβος
balsam	ο βάλσαμος
to snow	χιονίζω
to tell	λέω
to fill	γεμίζω
to lift	σηκώνω
to translate	μεταφράζω
to charge	χρεώνω
to deserve	αξίζω
to choke	πνίγω
to bake	ψήνω
to stay	μένω
seashore	η ακτή
return	η επιστροφή
girder	η δοκός
authoress	η συγγραφέας
writing	η γραφή
hearing	η ακοή
start	η αρχή
sculpture	η γλυπτική
season	η εποχή
gust	η ριπή
immortal	αθάανατος
absolute	απόλυτος
unwieldy	αδέξιος
cruel	απάνθρωπος
doubtful	αμφίβολος
sixth	έκτος
finished	τελειωμένος
mild	ήπιος
charitable	φιλεύσπλαχνος
clever	έξυπνος
serf	ο σκλάβος
palate	ο ουρανίσκος
builder	οοικοδόμος
dragon	ο δράκος
ward	ο θάλαμος
helmsman	ο πηδαλιούχος
advocate	ο δικηγόρος
branch	ο κλάδος
orphan	ο ορφανός
tattler	ο φλυαρός
to degenerate	εκφυλίζομαι
to qualify	προκρίνομαι
to wither	μαραίνομαι
to sway	λικνίζομαι
to trade	εμπορεύομαι
to correspond	ανταποκρίνομαι
to sag	κοιλαίνομαι
to cooperate	συνεργάζομαι
to protest	διαμαρτύρομαι
to contrive	μηχανεύομαι
untruth	το ψέμα
pity	το κρίμα
hug	το αγκάλιασμα
currency	το νόμισμα
wire	το σύρμα
dent	το βαθούλωμα
creature	το πλάσμα
range	το φάσμα
sneeze	το φτάρνισμα
wit	το πνεύμα
easily	εύκολα
before	πριν
rather	μάλλον
remarkably	αξιόλογα
ago	πριν
indeed	πράγματι
further	περαιτέρω
hundred	εκατό
badly	κακά
quietly	ήσυχα
easily	εύκολα
before	πριν
rather	μάλλον
remarkably	αξιόλογα
ago	πριν
indeed	πράγματι
further	περαιτέρω
hundred	εκατό
badly	κακά
quietly	ήσυχα
effort	η προσπάθεια
doll	η κούκλα
speech	η ομιλία
group	η ομάδα
history	η ιστορία
course	η πορεία
country	η χώρα
gate	η θύρα
maid	η καμαριέρα
poplar	η λεύκα
to awaken	ξυπνώ
to dally	χρονοτριβώ
to engender	γεννώ
to lust	ποθώ
to assist	βοηθώ
to disburse	δαπανώ
to expound	επεξηγώ
to replace	αντικαθιστώ
to appreciate	εκτιμώ
to detach	αποσπώ
portrait	το πορτραίτο
waistcoat	το γιλέκο
cloud	το σύννεφο
hotel	το ξενοδοχείο
stretcher	τοφορίο
hindrance	το εμπόδιο
smithy	το σιδηρουργείο
log	το κούτσουρο
berry	τομούρο
airport	το αεροδρόμιο
obstructive	κωλυσιεργός
tactical	τακτικός
oblique	λοξός
believable	πιστευτός
slender	λεπτός
surgical	χειρουργικός
riotous	στασιαστικός
shaggy	μαλλιαρός
dull	μουντός
excruciating	βασανιστικός
joint	η άρθρωση
deed	η πράξη
detour	ηλοξοδρόμηση
disdain	η περιφρόνυση
uprising	η εξέργεση
spider	η αράχνη
quest	η αναζήτηση
interview	η συνέντευξη
warning	η προειδοποίηση
outcome	η έκβαση
to diverge	εκτρέπομαι
to scuffle	συμπλέκομαι
to originate	προέρχομαι
to loathe	απεχθάνομαι
to grovel	ταπεινώνομαι
to enlist	κατατάσσομαι
to hint	υπαινίσσομαι
to abhor	απεχθάνομαι
to condescend	καταδέχομαι
to nestle	κουλουριάζομαι
secret	το μυστικό
staff	το προσωπικό
disgrace	το αίσχος
paddle	το κουπί
wool	το μαλλί
thickness	το πάχος
hum	το βουητό
percentage	το ποσοστό
mosque	το τζαμί
button	το κουμπί
adventurous	περιπετειώδης
unfinished	ατελής
sandy	αμμώδης
slavish	δουλοπρεπής
enduring	διαρκής
infirm	αρρωστιάρης
foggy	ομιχλώδης
inconsiderate	αγενής
continuously	συνεχώς
fleshy	σαρκώδης
theory	η θεορία
police	η αστυνομία
governess	η γκουβερνάντα
language	η γλώσσα
hunger	η πείνα
pipe	η πίπα
freedom	η ελευθερία
heel	η φτέρνα
madness	η τρέλα
tub	η μπανιέρα
to introduce	εισάγω
to behold	βλέπω
to describe	περιγράφω
to grasp	αρπάζω
to suppose	υποθέτω
to share	μοιράζω
to whistle	σφυρίζω
to establish	ιδρύω
to blush	κοκκινίζω
to acquaint	εξοικειώνω
lantern	το φανάρι
reed	το καλάμι
sheet	το σεντόνι
ceiling	το ταβάνι
fable	το παραμύθι
litter	το σκουπίδι
plough	το αλέτρι
mouse	το ποντίκι
grape	το σταφύλι
stork	το λελέκι
responsible	υπεύθυνος
gracious	ευχάριστος
modern	σύγχρονος
powerless	αδύναμος
innocent	αθώος
invisible	αόρατος
big	μεγάλος
livid	μολυβόχρωμος
unbelievable	απίστευτος
amusing	αστείος
price	η τιμή
affection	η στοργή
counsel	η συμβουλή
insult	η προσβολή
endurance	η αντοχή
roar	η κραυγή
choice	η επιλογή
thread	η κλωστή
structure	η δομή
fold	η πτυχή
to whine	κλαίγομαι
to advert	αναφέρομαι
to strut	κορδώνομαι
to behave	συμπεριφέρομαι
to joke	αστιεύομαι
to despair	απελπίζομαι
to relent	κάμπτομαι
to revolve	περιστρέφομαι
to elapse	παρέρχομαι
to deliberate	συσκέπτομαι
snore	το ροχάλισμα
ore	το μετάλλευμα
banknote	το χαρτονόμισμα
stopper	το πώμα
bundle	το δέμα
rascal	το κάθαρμα
message	το μήνυμα
barricade	το οδόφραγμα
straightness	το ίσιασμα
numbness	το μούδιασμα
about	περίπου
certainly	βέβαια
something	κάτι
secondary	δευτερεύων
zero	μηδέν
properly	σωστά
between	μεταξύ
quarter	τέταρτο
every	κάθε
while	ενώ
nail	η πρόκα
locker	η θυρίδα
wharf	η αποβάθρα
skill	η δεξιότητα
foresight	η πρόνοια
household	η οικία
suitcase	η βαλίτσα
keel	η καρίνα
stench	η δυσοσμία
pound	η λίρα
to defy	αψηφώ
to administer	διοικώ
to confiscate	κατασχώ
to adorn	κοσμώ
to rebel	επαναστατώ
to cultivate	καλλιεργώ
to annoy	ενοχλώ
to immunize	ανοσοποιώ
to covet	εποφθαλμιώ
to decorate	διακοσμώ
herb	το βότανο
pebble	το βότσαλο
landmark	τοορόσημο
load	το φορτίο
padlock	το λουκέτο
plum	το δαμάσκηνο
movie	το έργο
symbol	το σύμβολο
stand	το περίπτερο
draft	το προσχέδιο
kinetic	κινητικός
systematic	συστηματικός
exciting	συναρπαστικός
boiled	βραστός
contemptuous	περιφρονητικός
libelous	δυσφημιστικός
outward	εξωτερικός
hooked	γαμψός
energetic	ενεργετικός
chronological	χρονολογικός
sum	η πράξη
conscience	η συνείδηση
will	η διαθήκη
advertisement	η διαφήμηση
plea	η έκκληση
revenge	η εκδίκηση
offence	η παραβίαση
charity	η ελεημοσύνη
pageant	η επίδειξη
reconciliation	η συμφιλίωση
to censure	μέμφομαι
to hobnob	συναναστρέφομαι
to arrogate	σφετερίζομαι
to embezzle	σφετερίζομαι
to brawl	διαπληκτίζομαι
to militate	αντιμάχομαι
to overrun	λυμαίνομαι
to cluster	συγκεντρώνομαι
to belch	ρεύομαι
to snuggle	κουκουλώνομαι
net	το δίχτυ
style	το ύφος
tin	το κουτί
pen	το στυλό
groan	το βογγητό
rung	το σκαλί
profit	το κέρδος
ground	το έδαφος
event	το γεγονός
cinema	το σινεμά
inconsistent	ασυνεπής
profitless	ανωφελής
improper	απρεπής
subservient	δουλοπρεπής
uncivil	αγενής
princely	μεγαλοπρεπής
impolite	αγενής
unseemly	απρεπής
hideous	απεχθής
broadly	ευρέως
empire	η αυτοκρατορία
concert	η συναυλία
dozen	η δωδεκάδα
suspicion	η υποψία
soup	η σούπα
beard	η γενίαδα
chain	η αλυσίδα
bee	η μέλισσα
security	η ασφάλεια
camel	η καμήλα
to allow	επιτρέπω
to brew	βράζω
to unload	ξεφορτώνω
to weaken	εξασθενίζω
to mix	ανακατεύω
to omit	παραλείπω
to lash	μαστιγώνω
to advise	συμβουλεύω
to ascend	ανεβαίνω
to specify	καθορίζω
bracelet	το βραχιόλι
worm	το σκουλήκι
jaw	το σαγόνι
wheat	το σιτάρι
dove	το περιστέρι
raven	το κοράκι
drawer	το συρτάρι
nightingale	το αηδόνι
channel	το κανάλι
cellar	το κελάρι
afraid	φοβισμένος
wealthy	πλούσιος
pregnant	έγκυος
seldom	σπάνιος
generous	γενναιόδωρος
impatient	ανυπόμονος
quick	γρήγορος
pitiful	αξιολύπητος
mediocre	μέτριος
plenty	άφθονος
reproach	η μομφή
peninsula	η χερσόνησος
fondness	η στοργή
signature	η υπογραφή
homage	η υποταγή
split	η σχισμή
menace	η απειλή
theft	η κλοπή
shout	η κραυγή
possession	η κατοχή
to refer	αναφέρομαι
to gravitate	έλκομαι
to deviate	εκτρέπομαι
to wreathe	περιελίσσομαι
to enjoin	εντέλλομαι
to abscond	κρύβομαι
to scant	τσιγγουνεύομαι
to vie	συναγωνίζομαι
to ensue	έπομαι
to visualize	φαντάζομαι
strain	το τέντωμα
wonder	το θαύμα
victim	το θύμα
spread	το άπλωμα
mixture	το μίγμα
system	το σύστημα
errand	το θέλημα
vault	το άλμα
farm	το αγρόκτημα
weir	το φράγμα
neatly	κομψά
forward	μπροστά
present	παρών
fewest	ελάχιστοι
unusually	ασυνήθιστα
when	πότε
anywhere	οπουδήποτε
thousand	χίλια
thankful	ευγνώμων
speedily	γοργά
angle	η γωνία
harshness	η σκληρότητα
peel	η φλούδα
boredom	η βαριεστημάδα
difficulty	η δυσκολία
ewe	η προβατίνα
fun	η πλάκα
chimney	η καμινάδα
maidservant	η υπηρέτρια
detail	η λεπτομέρεια
to suffocate	ασφυκτιώ
to sympathize	συμπονώ
to deduct	αφαιρώ
to squeeze	ζουλώ
to supervise	επιστατώ
to writhe	σπαρταρώ
to chatter	φλυαρώ
to sparkle	σπινθηροβολώ
to linger	βραδυπορώ
to testify	μαρτυρώ
cement	το τσιμέντο
starch	το άμυλο
peach	το ροδάκινο
pledge	το ενέχυρο
raspberry	το σμέουρο
coal	το κάρβουνο
velvet	το βελούδο
restaurant	το εστιατόριο
encampment	το στρατόπεδο
fruit	το φρούτο
caustic	καυστικός
unassuming	σεμνός
attainable	εφικτός
unearthly	υπερφυσικός
philosophical	φιλοσοφικός
matching	ταιριαστός
memorial	αναμνηστικός
gaudy	φανταχτερός
bodily	σωματικός
tough	σκληρός
hearsay	η φήμη
contempt	η περιφρόνηση
guarantee	η εγγύηση
explanation	η εξήγηση
fatigue	η κόπωση
hurry	η βιασύνη
clasp	η πόρπη
crease	η τσάκιση
influenza	η γρίπη
seclusion	η απομόνωση
to adjudicate	αποφαίνομαι
to grapple	συμπλέκομαι
to trudge	σέρνομαι
to wed	παντρεύομαι
to embark	επιβιβάζομαι
to dangle	κρέμομαι
to coalesce	ενώνομαι
to exploit	εκμεταλλεύομαι
to consult	συμβουλεύομαι
to wield	χειρίζομαι
picnic	το πικνίκ
kiss	το φιλί
debt	το χρέος
store	το μαγαζί
arrow	το βέλος
ham	το ζαμπόν
fastener	το φερμουάρ
species	το είδος
member	το μέλος
fortress	το οχυρό
akin	συγγενής
sinewy	νευρώδης
principally	κυρίως
penurious	ενδεής
breezy	ανεμώδης
wavy	κυματώδης
clayey	πηλώδης
earthy	χωματώδης
loathsome	απεχθής
untrue	αναληθής
disorder	η αταξία
bank	η τράπεζα
bridge	η γέφυρα
accusation	η κατηγορία
mastery	η κυριότητα
rashness	η απερισκεψία
partridge	η πέρδικα
drop	η σταγόνα
disgust	η αηδία
flattery	η κολακεία
to deliver	παραδίδω
to suggest	προτείνω
to increase	αυξάνω
to shout	φωνάζω
to regulate	ρυθμίζω
to shear	κόβω
to portray	απεικονίζω
to mow	θερίζω
to print	τυπώνω
to risk	ριψοκινδινεύω
shilling	το σελίινι
bell	το κουδούνι
rent	το νοίκι
nut	το φυστίκι
stream	το ρυάκι
crate	το καφάσι
handkerchief	το μαντήλι
jacket	το σακάκι
falcon	το γεράκι
claw	το νύχι
adult	ενήλικος
vulgar	χυδαίος
suitable	κατάλληλος
monstrous	τεράστιος
seventh	έβδομος
ferocious	άγριος
tenacious	επίμονος
straight	ίσιος
pleasant	ευχάριστος
fatal	μοιραίος
epoch	η εποχή
engine	η μηχανή
inscription	η επιγραφή
epistle	η επιστολή
forbearance	η υπομονή
exit	η έξοδος
excuse	η αφορμή
destruction	η καταστροφή
precept	η αρχή
erasure	η διαγραφή
to bawl	ωρύομαι
to cogitate	συλλογίζομαι
to rave	παραλογίζομαι
to hark	αφουγκράζομαι
to drown	πνίγομαι
to twine	περιελίσσομαι
to dwindle	μειώνομαι
to hearken	αφουγκράζομαι
to flock	συγκεντρώνομαι
to ramify	διακλαδίζομαι
coin	το κέρμα
token	το δείγμα
band	το συγκρότημα
leather	το δέρμα
footstep	το πάτημα
topic	το θέμα
revenue	το εισόδημα
sway	το λίκνισμα
diploma	το δίπλωμα
iota	το γιώτα
firmly	σταθερά
indoors	μέσα
roughly	περίπου
strongly	δυνατά
whether	αν
plainly	καθαρά
dangerously	επικίνδυνα
gradually	σιγά-σιγά
logically	λογικά
dreadfully	φοβερά
quality	η ποιότητα
snare	η παγίδα
illness	η αρρώστεια
worth	η αξία
lyre	η λύρα
slice	η φέτα
conversation	η συνομιλία
province	η επαρχία
fairness	η αμεροληψία
banner	η σημαία
to moan	βογγώ
to suspend	κρεμώ
to revive	αναζωγονώ
to dominate	κυριαρχώ
to unsettle	ανησυχώ
to evaluate	εκτιμώ
to yearn	λαχταρώ
to exempt	εξαιρώ
to systematize	συστηματοποιώ
to disgrace	ατιμώ
loan	το δάνειο
desk	το θρανίο
complaint	το παράπονο
sticker	το αυτοκόλλητο
castle	το κάστρο
basement	το υπόγειο
timetable	το ωράριο
packhorse	το υποζύγιο
surname	το επίθετο
weed	το ζιζάνιο
tight	σφιχτός
asinine	γαϊδουρινός
chemical	χημικός
strategic	στρατηγικός
homesick	νοσταλγός
hearty	σθεναρός
sly	πονηρός
lowly	χαμηλός
beloved	αγαπητός
choral	χορικός
understanding	η κατανοήση
vexation	η ενόχληση
confidence	η εμπιστοσύνη
direction	η κατεύθυνση
belief	η πίστη
ashes	η στάχτη
syntax	η σύνταξη
treaty	η συνθήκη
climb	η ανάβαση
exercise	η άσκηση
to scrimp	τσιγγουνεύομαι
to mediate	στοχάζομαι
to assail	επιτίθεμαι
to budge	κινούμαι
to disclaim	αποποιούμαι
to clamber	αναρριχώμαι
to disown	αποποιούμαι
to overhang	επικρέμαμαι
to invoke	επικαλούμαι
to sham	προσποιούμαι
sob	το αναφιλητό
dynamo	το δυναμό
female	το θυληκό
rope	το σχοινί
cloth	το πανί
environment	το περιβάλλον
mistake	το λάθος
liquid	το υγρό
cheese	το τυρί
term	το όρος
leafy	φυλλώδης
poisonous	δηλητηριώδης
stormy	θυελλώδης
fundamental	θεμελιώδης
unmistakable	καταφανής
hazy	ομιχλώδης
swampy	ελώδης
grassy	χλοώδης
hygienic	υγιής
ashy	τεφρώδης
pond	η λιμνούλα
sweetness	η γλύκα
towel	η πετσέτα
wickedness	η κακία
nurse	η νοσοκόμα
insanity	η τρέλα
absence	η απουσία
satire	η σάτιρα
shrine	η λάρνακα
baldness	η φαλάκρα
to undertake	αναλαμβάνω
to sharpen	ακονίζω
to express	εκφράζω
to plant	φυτεύω
to heave	βιράρω
to mount	ανεβαίνω
to descend	κατεβαίνω
to fix	φτιάχνω
to frighten	φοβίζω
to giggle	χαχανίζω
tale	το παραμύθι
fireplace	το τζάκι
trousers	το παντελόνι
fish	το ψάρι
roll	το ψωμάκι
ring	το δακτυλίδι
ant	το μυρμηγκι
drain	το λούκι
knife	το μαχαίρι
pepper	το πιπέρι
glorious	ένδοξος
worse	χειρότερος
sublime	τέλειος
certain	βέβαιος
inferior	κατώτερος
glad	χαρούμενος
stout	εύσαρκος
fine	ωραίος
primitive	πρωτόγονος
witty	σπιρτόζος
strand	η ακτή
board	η επιτροπή
inducement	η προτοπή
stewardess	η αεροσυνοδός
scream	η κραυγή
contact	η επαφή
recess	η εσοχή
tent	η σκηνή
vertex	η κορυφή
rush	ηορμή
to delude	εξαπατώ
to monopolize	μονοπωλώ
to exalt	εξαίρώ
to frisk	χοροπηδώ
to execute	εκτελώ
to circulate	κυκλοφορώ
to revolt	επαναστατώ
to prosper	ευημερώ
to misrepresent	παραποιώ
to cause	προκαλώ
brandy	το κονιάκ
amount	το ποσό
passion	το πάθος
sort	το είδος
depth	το βάθος
oar	το κουπί
shower	το ντους
moan	το βογγητό
score	το σκορ
hate	το μίσος
everyone	όλοι
loudly	δυνατά
among	ανάμεσα
nowhere	πουθενά
gracefully	χαριτωμένα
boldly	θαρραλέα
since	από
faithfully	πιστά
former	πρώην
disrespectfully	ασεβέστατα
vice	η φαυλότητα
harmony	η αρμονία
sin	η αμαρτία
inquiry	η έρευνα
liveliness	η ζωηρότητα
farming	η γεωργία
flag	η σημαία
heifer	η δαμάλα
skirmish	η αψιμαχία
lightness	η ελαφρότητα
to climb	σκαρφαλώνω
to bind	δένω
to shine	λάμπω
to clothe	ντύνω
to publish	εκδίδω
to found	ιδρύω
to enjoy	απολαμβάνω
to adjust	πυθμίζω
to pronounce	προφέρω
to support	υποστηρίζω
wreck	το ναυάγιο
theatre	το θέατρο
piano	το πιάνο
bow	το τόξο
mystery	το μυστήριο
post	το ταχυδρομείο
javelin	το ακόντιο
anklet	το περισφύριο
cocoa	το κακάο
trick	το κόλπο
equestrian	ιππικός
migratory	αποδημητικός
daring	τολμηρός
lax	χαλαρός
besides	εκτός
crank	εκκεντρικός
closed	κλειστός
environmental	περιβαλλοντικός
biting	δηκτικός
hanging	κρεμαστός
regret	η λύπη
mud	η λάσπη
anguish	η οδύνη
vigour	η δύναμη
justice	η δικαιοσύνη
test	η εξέταση
compliance	η συμμώρφωση
parade	η παρέλαση
encirclement	η περικύκλωση
exhaust	η εξάτμιση
to groan	βογγώ
to normalize	ομαλοποιώ
to extract	αποσπώ
to philosophize	φιλοσοφώ
to subtract	αφαιρώ
to disquiet	ανησυχώ
to satiate	ικανοποιώ
to ache	πονώ
to initiate	μυώ
to recall	ανακαλώ
cavalry	το ιππικό
pouch	το πουγγί
error	το λάθος
island	το νησί
sweater	το πούλοβερ
drink	το ποτό
overcoat	το παλτό
bunch	το τσαμπί
beast	το κτήνος
magazine	το περιοδικό
prickly	ακανθώδης
lasting	διαρκής
frothy	αφρώδης
devotional	ευσεβής
altogether	εντελώς
boastful	καυχησιάρης
distinctly	σαφώς
somewhat	κάπως
mossy	βρυώδης
inert	αδρανής
search	η έρευνα
reality	η πραγματικότητα
proverb	η παροιμία
stump	η ρίζα
sacrifice	η θυσία
uncertainty	η αβεβαιώτητα
chorus	η χορωδία
dampness	η υγρασία
widow	η χήρα
shrimp	η γαρίδα
to uncover	ξεσκεπάζω
to shatter	θρυμματίζω
to join	ενώνω
to withdraw	αποσύρω
to bid	προσφέρω
to greet	χαιρετίζω
to celebrate	εορτάζω
to burst	σκάω
to succeed	πετυχαίνω
to loosen	χαλαρώνω
pencil	το μολύβι
star	το αστέρι
eel	το χέλι
peacock	το παγόνι
serpent	το φίδι
liver	το συκώτι
gunpowder	το μπαρούτι
seedling	το φιντάνι
bottle	το μπουκάλι
path	το μονοπάτι
rusty	σκουριασμένος
foreign	ξένος
remarkable	αξιόλογος
unusual	ασυνήθιστος
extravagant	σπάταλος
unfair	άδικος
disreputable	κακόφημος
indispensable	απαραίτητος
infamous	διαβόητος
intense	έντονος
countryside	η εξοχή
guilt	η ενοχή
thesis	η διατριβή
ointment	η αλοιφή
stage	η σκηνή
pretext	η αφορμή
devastation	η καταστροφή
excess	η υπερβολή
crevice	η ρωγμή
ruin	η καταστροφή
to counteract	αντενεργώ
to tranquillize	ηρεμώ
to calm	ηρεμώ
to bestow	κληροδοτώ
to intoxicate	μεθώ
to regard	θεωρώ
to disable	ακινητοποιώ
to sniff	ρουφώ
to overpower	κατανικώ
to bewail	μοιρολογώ
infant	το βρέφος
occurrence	το συμβάν
ululation	το ουρλιαχτό
boss	το αφεντικό
fort	το οχυρό
feature	το χαρακτηριστικό
finish	το τέλος
cab	το ταξί
issue	το τεύχος
dictionary	το λεξικό
sensibly	λογικά
seriously	σοβαρά
presently	σύντομα
beside	δίπλα
respectfully	σεβαστά
urgent	επείγων
freely	ελεύθερα
swiftly	γοργά
openly	ανοικτά
poorly	φτωχά
weakness	η αδυναμία
craving	η λαχτάρα
toothpaste	η οδοντόπαστα
tape	η ταινία
likeness	η ομοιώτητα
fashion	η μόδα
merit	η αξία
thimble	η δακτυλήθρα
presence	η παρουσία
stupidity	η ανοησία
to nourish	θρέφω
to hinder	εμποδίζω
to upset	αναστατώνω
to present	παρουσιάζω
to compare	συγκρίνω
to untie	ξεδένω
to sprain	στραμπουλίζω
to strengthen	ενισχύω
to own	κατέχω
to stir	ανακατεύω
cemetery	το νεκροταφείο
horseshoe	το πέταλο
kingdom	το βασιλείο
chapter	το κεφάλαιο
scheme	το σχέδιο
subject	το υποκείμενο
push	το σπρώξιμο
joke	το αστείο
frontier	τοσύνορο
maximum	το μέγιστο
hundredth	εκατοστός
disadvantageous	μειωνεκτικός
correct	σωστός
straightforward	απλός
sightless	τυφλός
quarrelsome	εριστικός
leading	πρωταγωνιστικός
abusive	υβριστικός
slack	χαλαρός
orderly	μεθοδικός
inquisitiveness	πολυπραγματοσύν
stern	η πρύμνη
exhaustion	η εξάντληση
ostentation	η επίδειξη
migration	η μετανάστευση
judgment	η κρίση
prestige	η αίγλη
completion	η ολοκλήρωση
abbreviation	η συντώμευση
hint	η νύξη
to commend	επαινώ
to speculate	κερδοσκοπώ
to pacify	ειρηνοποιώ
to thrash	ξυλοκοπώ
to forewarn	προειδοποιώ
to utilize	χρησιμοποιώ
to dip	βουτώ
to amend	τροποποιώ
to steady	σταθεροποιώ
to concede	παραχωρώ
steeple	το καμπαναριό
breadth	το φάρδος
cell	το κελί
forum	τοφόρουμ
cleanser	το καθαριστικό
talisman	το φυλακτό
sack	το σακκί
stake	το στοίχημα
honeysuckle	το αιγόκλημα
accomplishment	το κατόρθωμα
exactly	ακριβώς
windy	ανεμώδης
godly	θεοσεβής
bombastic	στομφώδης
anyhow	πάντως
baggy	φαρδύς
weakly	ασθενώς
possibly	ίσως
miserly	τσιγγούνης
affable	προσηνής
wrinkle	η ρυτίδα
betrayal	η προδοσία
contention	η φιλονικία
mess	η ακαταστασία
mustard	η μουστάρδα
cream	η κρέμα
cart	η άμαξα
mare	η φοράδα
deal	η συμφωνία
guardianship	η κηδεμονία
to indicate	ενδεικνύω
to achieve	καταφέρνω
to sanctify	αγιάζω
to harm	βλάπτω
to stream	ρέω
to restore	επαναφέρω
to kneel	γονατίζω
to sow	σπέρνω
to hesitate	διστάζω
to assuage	κατευνάζω
sleeve	το μανίκι
stick	το μπαστούνι
balcony	το μπαλκόνι
trip	το ταξιδάκι
bazaar	το παζάρι
teaspoon	το κουτάλι
pomegranate	το ρόδι
feast	το γλέντι
pigeon	το περιστέρι
shawl	το σάλι
fast	γρήγορος
magnificent	θαυμάσιος
legitimate	νόμιμος
private	ιδιαίτερος
plain	σκέτος
vertical	κάθετος
victorious	νικηφόρος
wretched	κακόμοιρος
delicious	νόστιμος
obscene	χυδαίος
perseverance	η επιμονή
committee	η επιτροπή
honor	η τιμή
postponement	η αναβολή
dye	η βαφή
hush	η σιωπή
nutriment	η τροφή
hurt	η πληγή
actress	η ηθοποιός
continent	η ήπειρος
to mislead	παραπλανώ
to socialize	κοινωνικοποιώ
to stoke	τροφοδοτώ
to abolish	καταργώ
to embroider	κεντώ
to squander	κατασπαταλώ
to absorb	απορροφώ
to paste	κολλώ
to post	ταχυδρομώ
to desensitize	απευαισθητοποιώ
cookie	το μπισκότο
circus	το τσίρκο
fine	το πρόστιμο
present	το δώρο
ivory	το ελεφαντόδοντο
cape	το ακρωτήριο
instrument	το όργανο
notebook	το τετράδιο
shipwreck	το ναυάγιο
dollar	το δολάριο
reluctantly	απρόθυμα
again	ξανά
eagerly	πρόθυμα
several	αρκετοί
kindly	ευγενικά
hardly	σχεδόν
neither	ούτε
crowded	φίσκα
especially	ειδικά
furthermore	επιπλέον
jug	η κανάτα
estate	η περιουσία
screw	η βίδα
dot	η κουκκίδα
portion	η μερίδα
wedge	η σφήνα
conspiracy	η συνωμοσία
disease	η αρρώστια
flannel	η φανέλα
drought	η ξηρασία
to include	περιέχω
to disinherit	αποκληρώνω
to encompass	περικυκλώνω
to enclose	εσωκλείω
to encourage	ενθαρρύνω
to handle	μεταχειρίζω
to stab	μαχαιρώνω
to grab	αρπάζω
to enter	μπαίνω
to behead	αποκεφαλίζω
scythe	το δρεπάνι
threshold	το κατώφλι
chick	το κοτοπουλάκι
cotton	το βαμβάκι
tumbler	το ποτήρι
song	το τραγούδι
shell	το κοχύλι
snail	το σαλιγκάρι
furrow	το αυλάκι
pawn	το πιόνι
tepid	χλιαρός
sound	γερός
scathing	καυστικός
heartbreaking	θλιβερός
forbearing	ανεκτικός
scanty	λιγοστός
curly	σγουρός
significant	σημαντικός
flaming	φλογερός
oily	λαδερός
seizure	η σύλληψη
amazement	η κατάπληξη
dismay	η απογοήτευση
resolution	η λύση
lawsuit	η δίκη
strength	η δύναμη
combat	η μάχη
charge	η επιβάρυνση
release	η απελευθέρωση
oversight	η παράβλεψη
to vocalize	φωνώ
to mash	πολτοποιώ
to advocate	συνιστώ
to tickle	γαργαλώ
to pulverize	κονιοποιώ
to vibrate	δονώ
to calibrate	διαμετρώ
to diddle	εξαπατώ
to tote	κουβαλώ
to annotate	σχολιογραφώ
weapon	το όπλο
knapsack	το σακκίδιο
palace	το ανάκτορο
factory	το εργοστάσιο
medicine	το φάρμακο
conference	το συνέδριο
treasury	ο θησαυροφυλάκιο
eyelash	το τσίνορο
square	το τετράγωνο
salary	το μηνιάτικο
merely	απλώς
bloodthirsty	αιμοδιψής
moderate	μετριοπαθής
knotty	οζώδης
alongside	παραπλεύρως
weighty	βαρύς
studious	επιμελής
negligent	αμελής
noisy	θορυβώδης
keen	ενθουσιώδης
affliction	η ασθένεια
taxation	η φορολογία
coolness	η ψύχρα
flood	η πλημμύρα
drowsiness	η νύστα
ball	η μπάλα
abundance	η αφθονία
jumble	η ανακατωσούρα
picture	η εικόνα
lining	η φόδρα
to pile	συσσωρεύω
to pursue	καταδιώκω
to submit	υποβαλλω
to enlarge	μεγεθύνω
to check	ελέγχω
to foresee	προβλέπω
to unfold	ξεδιπλώνω
to boil	βράζω
to fasten	κλείνω
to overflow	ξεχειλίζω
ditch	το χαντάκι
pot	το τσικάλι
harpoon	το καμάκι
fuse	το φυτίλι
sill	το περβάζι
porthole	το φινιστρίνι
pear	το αχλάδι
journey	το ταξίδι
earring	το σκουλαρίκι
swallow	το χελιδόνι
homelike	σπιτίκος
roomy	ευρύχωρος
original	πρωτότυπος
recent	πρόσφατος
atrocious	απαίσιος
identical	ίδιος
contemptible	αξιοκαταφρόντος
disloyal	άπιστος
whole	ολόκληρος
sorrowful	λυπημένος
performance	η απόδωση
refinement	η διύλιση
operation	η εγχείρηση
ornament	η διακόσμηση
sheath	η θήκη
denial	η άρνηση
brotherhood	η αδελφοσύνη
frustration	η ματαίωση
notice	η παρατήρηση
assault	η επίθεση
to solder	συγκολλώ
to succor	βοηθώ
to batter	χτυπώ
to research	ερευνώ
to glisten	λαμποκοπώ
to overawe	καταπτοώ
to stylize	σχηματοποιώ
to reside	κατοικώ
to bejewel	κοσμώ
to disagree	διαφωνώ
fief	το τιμάριο
eyelid	το βλέφαρο
sewing	το ράψιμο
design	το σχέδιο
plane	το αεροπλάνο
tool	το εργαλείο
swelling	το πρήξιμο
customs	το τελωνείο
bus	το λεωφορείο
invoice	το τιμολόγιο
lately	πρόσφατα
opposite	απέναντι
gently	ήπια
unexpectedly	απροσδόκητα
away	μακριά
somewhere	κάπου
quite	αρκετά
clearly	καθαρά
nearly	σχεδόν
provisionally	προσωρινά
timber	η ξυλεία
spark	η σπίθα
lioness	η λέαινα
thirst	η δίψα
locality	η τοποθεσία
usefulness	η χρησιμότητα
care	η φροντίδα
bribe	η δωροδοκία
flatness	η επιπεδότητα
location	η τοποθεσία
to reap	δρέπω
to resolve	αποφασίζω
to submerge	καταδύω
to distribute	διανέμω
to contribute	συνεισφέρω
to collect	συλλέγω
to secure	εξασφαλίζω
to convince	πείθω
to interrupt	διακόπτω
to cleanse	καθαρίζω
honey	το μέλι
darkness	το σκοτάδι
syrup	το σιρόπι
bud	το μπουμπούκι
top	το καπάκι
rag	το κουρέλι
turpentine	το νέφτι
spool	το καρούλι
slap	το χαστούκι
cup	το φλυτζάνι
initial	αρχικός
able	ικανός
standard	κανονικός
afternoon	απογεματινός
alluring	δελεαστικός
esteemed	σεβαστός
arid	ξηρός
unpolluted	καθαρός
gruff	αγριωπός
solitary	μοναχικός
oats	η βρώμη
decision	η απόφαση
art	η τέχνη
mist	η ομίχλη
recollection	η ανάμνηση
evidence	η απόδειξη
opinion	η γνώμη
deception	η απάτη
faith	η πίστη
recovery	η ανάρρωση
to glue	κολλώ
to discredit	δυσφημώ
to swoop	εφορμώ
to collate	ταξινομώ
to navigate	ναυσιπλοώ
to recede	υποχωρώ
to enumerate	απαριθμώ
to overestimate	υπερτιμώ
to unnerve	πτοώ
to bemoan	θρηνώ
laughter	το γέλιο
coffin	το φέρετρο
cymbal	το κύμβαλο
casket	το φέρετρο
garment	το ρούχο
agency	το πρακτορέιο
twilight	τοσούρουπο
cautery	το καυτήριο
fare	το εισιτήριο
workshop	το εργαστήριο
congenial	συγγενής
misty	ομιχλώδης
chiefly	κυρίως
unambiguous	σαφής
obstinate	πεισματώδης
international	διεθνής
scented	ευώδης
outstanding	διαπρεπής
flared	φαρδύς
moronic	βλακώδης
discord	η διαφωνία
feebleness	η αδυναμία
team	η ομάδα
unrest	η ανησυχία
agreement	η συμφωνία
bribery	η δωροδοκία
strawberry	η φράουλα
frugality	η λιτότητα
accord	η συμφωνία
martyrdom	η μαρτυρία
to chide	μαλώνω
to gain	κερδίζω
to conceal	κρύβω
to moor	προσδένω
to dampen	υγραίνω
to reckon	υπολογίζω
to fry	τηγανίζω
to suffice	φθάνω
to alter	αλλάζω
to attract	προσελκύω
ravine	το φαράγγι
silk	το μετάξι
anvil	το αμόνι
tablet	το χάπι
peg	το μανταλάκι
udder	το μαστάρι
toy	το παιχνίδι
onion	το κρεμμύδι
track	το μονοπάτι
axe	το τσεκούρι
adroit	επιδέξιος
huge	τεράστιος
shameful	επαίσχυντος
reluctant	απρόθυμος
gigantic	γιγάντιος
imperceptible	ανεπαίσθητος
bold	θαρραλέος
wounded	τραυματισμένος
irregular	ανώμαλος
untouched	άθικτος
mistress	η ερωμένη
blindness	η τύφλωση
procession	η παρέλαση
sparkle	η λάμψη
annoyance	η ενόχληση
riverbank	η όχθη
buckle	η πόρπη
science	η επιστήμη
increase	η αύξηση
haste	η βιασύνη
to poke	σκουντώ
to flank	πλευροκοπώ
to contort	συσπώ
to bereave	αποστερώ
to reek	βρωμώ
to overhaul	προσπερνώ
to hoodwink	εξαπατώ
to personify	προσωποποιώ
to retain	κατακρατώ
to superintend	επιστατώ
gift	το δώρο
total	το σύνολο
bicycle	το ποδήλατο
obstacle	το εμπόδιο
bier	το βάθρο
fortnight	το δεκαπενθήμερο
chicken	το κοτόπουλο
stoop	το σκύψιμο
nerve	το νεύρο
bulwark	το προπύργιο
usefully	χρήσιμα
excellently	άριστα
firstly	πρώτα
striped	ριγέ
terribly	φοβερά
softly	μαλακά
strangely	περίεργα
splendidly	υπέροχα
cheaply	φτηνά
fewer	λιγότεροι
indolence	η νωθρότητα
sunshine	η ηλιακάδα
zebra	η ζέβρα
muddle	η ανακατωσούρα
crust	η κρούστα
locust	η ακρίδα
residence	η κατοικία
stiffness	η δυσκαμψία
attempt	η προσπάθεια
avarice	η φιλαργυρία
to husk	ξεφλουδίζω
to repair	επισκευάζω
to belong	ανήκω
to forsake	εγκαταλείπω
to arise	προκύπτω
to enthrall	υποδουλώνω
to rub	τρίβω
to tire	κουράζω
to hack	πετσοκόβω
to intend	σκοπεύω
oyster	το στρείδι
shin	το καλάμι
octopus	το χταπόδι
shelf	το ράφι
loaf	το καρβέλι
fountain	το συντριβάνι
tangerine	το μανδαρίνι
cushion	το μαξιλάρι
puppy	το κουταβάκι
ox	το βόδι
mixed	μικτός
fiftieth	πεντηκοστός
mournful	θλιβερός
hesitant	διστακτικός
inner	εσωτερικός
voluntary	εθελοντικός
crazy	τρελός
thoughtful	σκεπτικός
understandable	κατανοητός
winged	πτερωτός
advocacy	η υποστήριξη
repetition	η επανάληψη
guidance	η καθοδήγηση
atonement	η επανόρθωση
opposition	η αντίσταση
request	η παράκληση
answer	η απάντηση
power	η δύναμη
scorn	η περιφρόνηση
addition	η πρόσθηκη
to tarry	αργοπορώ
to blather	φλυαρώ
to supersede	αντικαθιστώ
to berate	επιτιμώ
to slither	γλιστρώ
to empower	εξουσιοδοτώ
to surmount	ξεπερνώ
to mar	χαλώ
to hurtle	ορμώ
to convene	συγκαλώ
suburb	το προάστιο
entirety	το σύνολο
rose	το τριαντάφυλλο
rectangle	το ορθογώνιο
hydrogen	το υδρογώνο
hemisphere	το ημισφαίριο
metal	το μέταλλο
welt	το βάρδουλο
baton	το ρόπαλο
garland	το στεφάνι
gaping	χάσκωντας
entreating	εκλιπαρώντας
seemly	ευπρεπής
soapy	σαπωνώδης
conspicuous	εμφανής
ungentlemanly	αναξιοπρεπής
trembling	τρέμωντας
centennial	εκατονταετής
lisping	ψευδίζοντας
destitute	ενδεής
dwelling	η κατοικία
lemonade	η λεμονάδα
neatness	η κομψότητα
needle	η βελόνα
baton	η μπαγκέτα
eggplant	η μελιτζάνα
gentleness	η ηπιότητα
seriousness	η σοβαρότητα
armchair	η πολυθρόνα
bag	η τσάντα
to tame	δαμάζω
to accomplish	επιτυγχάνω
to dismiss	απολύω
to thicken	πυκνώνω
to devote	αφιερώνω
to fail	αποτυγχάνω
to plead	ικετεύω
to reveal	αποκαλύπτω
to hum	βομβίζω
to invade	εισβάλλω
diamond	το διαμάντι
mat	το χαλάκι
poker	το σκαλιστήρι
thorn	το αγκάθι
wristband	το μανικέτι
coupon	το κουπόνι
seaweed	το φύκι
noon	το μεσιμέρι
chess	το σκάκι
speck	το στίγμα
incomprehensible	ακατανόητος
ninth	έννατος
distraught	ταραγμένος
unaffected	ανεπηρέαστος
eighth	όγδοος
eager	πρόθυμος
smooth	λείος
usual	συνηθισμένος
assured	σίγουρος
unequal	άνισος
sale	η πώληση
grace	η χάρη
belt	η ζώνη
haze	η ομίχλη
ease	η άνεση
sentence	η πρόταση
pact	η συνθήκη
compliment	ηφιλοφρόνυση
address	η διεύθυνση
fortification	η οχύρωση
to preserve	διατηρώ
to encode	κωδικοποιώ
to encroach	καταπατώ
to gesticulate	χειρονομώ
to upbraid	επιτιμώ
to snipe	πυροβολώ
to govern	κυβερνώ
to profess	ομολογώ
to twitch	συσπώ
to moralize	ηθικολογώ
syringe	η σύρριγα
curlew	η τουρλίδα
legion	η λεγεώνα
entertainment	η ψυχαγωγία
hardness	η σκληρότητα
spleen	η σπλήνα
dissension	η διχόνια
hardship	η ταλαιπορία
generosity	η γενναιοδωρία
instruction	η διδασκαλία
humbly	ταπεινά
sooner	συντομότερα
plentifully	άφθονα
honestly	ειλικρινά
many	πολλοί
unlikely	απίθανον
deeply	βαθιά
miserably	δυστυχισμένα
commonly	κοινά
afar	μακριά
debate	η συζήτηση
bluntness	η άμβλυνση
erosion	η διάβρωση
undertaking	η επιχείρηση
collision	η σύγκρουση
recompense	η αποζημίωση
transformation	η μεταμόρφωση
affair	η υπόθεση
dough	η ζύμη
forgiveness	η συγχώρεση
to sin	αμαρτάνω
to baptize	βαπτίζω
to harden	σκληραίνω
to banish	εξορίζω
to disclose	αποκαλύπτω
to gather	συγκεντρώνω
to refresh	δροσίζω
to twist	στρίβω
to destroy	καταστρέφω
to flay	γδέρνω
enchantment	η γοητεία
nakedness	η γυμνότητα
lot	η μοίρα
hostess	η οικοδέσποινα
carelessness	η απροσεξία
sunbeam	η αχτίδα
willow	η ιτέα
kindness	η ευγένεια
occasion	η ευκαιρία
luxury	η πολυτέλεια
medical	ιατρικός
nude	γυμνός
fair	ξανθός
plaintive	γοερός
advantageous	πλεονεκτικός
imperial	αυτοκρατορικός
dire	τρομερός
rhetorical	ρητορικός
spiritual	πνευματικός
fortieth	τεσσερακοστός
giddiness	η ζάλη
application	η αίτηση
retaliation	η ανταπόδοση
retirement	η αποχώρηση
lake	η λίμνη
wrestling	η πάλη
dimension	η διάσταση
glitter	η λάμψη
force	η δύναμη
infection	η λοίμωξη
to transfix	διατρυπώ
to enervate	εξαντλώ
to daunt	πτοώ
to bother	ενοχλώ
to plunge	βουτώ
to sort	τακτοποιώ
to discontent	δυσαρεστώ
to abash	πτοώ
to bounce	αναπηδώ
to radiate	ακτινοβολώ
tunnel	η σήραγγα
valley	η κοιλάδα
loss	η απώλεια
protection	η προστασία
loft	η σοφίτα
dignity	η αξιοπρέπεια
displeasure	η δυσαρέσκεια
perfection	η τελειότητα
shelter	η προστασία
hospitality	η φιλοξενία
wittily	ευφυώς
selfless	ανιδιοτελής
slight	ελαφρύς
unfavorable	δυσμενής
punctual	συνεπής
juicy	χυμώδης
turbulent	ταραχώδης
elementary	στοιχειώδης
purblind	μύωπας
dependable	συνεπής
bewilderment	η κατάπληξη
ailment	η πάθηση
goodness	η καλοσύνη
translation	η μετάφραση
abasement	η ταπείνωση
mood	η διάθεση
west	η δύση
bail	η εγγύηση
storehouse	η αποθήκη
responsibility	η ευθύνη
to lower	χαμηλώνω
to kindle	ανάβω
to shorten	κονταίνω
to exhibit	εκθέτω
to dismount	αφιππεύω
to degrade	υποβιβάζω
to stutter	τραυλίζω
to madden	τρελαίνω
to convey	μεταβιβάζω
to plough	οργώνω
utility	η ωφέλεια
witchcraft	η μαγεία
trouble	η φασαρία
legation	η πρεσβεία
poverty	η φτώχεια
dizziness	η ζαλάδα
fidelity	η πιστότητα
insolence	η αυθάδεια
napkin	η χαρτοπετσέτα
stair	η σκάλα
unfortunate	άτυχος
skilled	επιδέξιος
immodest	άσεμνος
dependent	εξαρτώμενος
unmoved	ασυγκίνητος
shameless	αναίσχυντος
bloody	ματωμένος
unpunished	ατιμώρητος
dejected	αποκαρδιωμένος
unworthy	ανάξιος
tradition	η παράδοση
exhibition	η έκθεση
wording	η διατύπωση
disembarkation	η αποβίβαση
removal	η μετακόμιση
contentment	η ικανοποίηση
evaluation	η αξιολόγηση
rye	η σίκαλη
trance	η έκσταση
inflammation	η μόλυνση
to ordain	χειροτονώ
to fulfil	εκπληρώ
to inspect	επιθεωρώ
to bound	αναπηδώ
to nationalize	κρατικοποιώ
to procrastinate	χρονοτριβώ
to tow	ρυμουλκώ
to dawdle	χασομερώ
to legalize	νομιμοποιώ
to espouse	υιοθετώ
cure	η θεραπεία
washer	η ροδέλα
caterpillar	η κάμπια
cultivation	η καλλιέργεια
owl	η κουκουβάγια
blister	η φουσκάλα
diligence	η εργτατικότητα
religion	η θρησκεία
trumpet	η σάλπιγγα
kinship	η συγγένεια
greatly	πολύ
cleverly	έξυπνα
diseased	αποθανών
rightly	δίκαια
happily	ευτυχισμένα
bravely	γενναία
secretly	μυστικά
outwardly	εξωτερικά
earnestly	σοβαρά
wildly	άγρια
revolution	η επανάσταση
tenancy	η μίσθωση
lance	η λόγχη
alms	η ελεημοσύνη
mane	η χαίτη
credit	η πίστωση
acquittal	η αθώωση
radiance	η λάμψη
commotion	η αναστάτωση
infraction	η παραβιάση
to identify	αναγνωρίζω
to betray	προδίδω
to urge	παροτρύνω
to remind	υπενθυμίζω
to exhort	προτρέπω
to terrify	τρομάζω
to select	διαλέγω
to communicate	επικοινώνω
to blind	τυφλώνω
to sour	ξινίζω
eloquence	η ευφράδεια
fate	η μοίρα
tragedy	η τραγωδία
grasshopper	η ακρίδα
foolishness	η χαζομάρα
louse	η ψείρα
meaning	η σημασία
mint	η μέντα
attendance	η παρουσία
plague	η πανούκλα
warlike	πολεμικός
treble	τριπλός
palatial	ανακτορικός
urban	αστικός
spineless	δειλός
philological	φιλολογικός
evil	κακός
infernal	διαβολικός
inexpensive	φτηνός
forked	διχαλωτός
sickness	η αρρώστεια
settlement	η αποικία
greed	η λαιμαργία
ratio	η αναλογία
blotch	η μουντζούρα
hornet	η σφήκα
hen	η κότα
unit	η μονάδα
kneecap	η επιγονατίδα
root	η ρίζα
to stabilize	σταθεροποιώ
to long	ποθώ
to prate	φλυαρώ
to jabber	γλωσσοκοπανώ
to fulfil	ικανοποιώ
to irradiate	ακτινοβολώ
to spawn	γεννώ
to vaporize	ατμοποιώ
to terrorize	τρομοκρατώ
to indict	κατηγορώ
balance	η ισορροπία
excellence	η αρτιότητα
equality	η ισότητα
ferocity	η αγριότητα
agriculture	η γεωργία
chill	η ψύχρα
gang	η συμμορία
property	η ιδιοκτησία
moisture	η υγρασία
adequacy	η επάρκεια
unresponsive	απαθής
erstwhile	τέως
frantic	αλλόφρονας
insufficient	ανεπαρκής
depositing	καταθέτοντας
inconstant	ασταθής
gaseous	αεριώδης
native	ιθαγεννής
prayerful	θεοσεβής
servile	δουλοπρεπής
bullet	η σφαίρα
marionette	η μαριονέτα
research	η έρευνα
shortness	η βραχύτητα
stripe	η ρίγα
desertion	η λιποταξία
princess	η πριγκήπισσα
eaves	η μαρκίζα
rubber	η γόμα
neighborhood	η γειτονία
to stink	βρωμάω
to fortify	οχυρώνω
to rouse	ξεσηκώνω
to afflict	πλήττω
to strangle	στραγγαλίζω
to renew	ανανεώνω
to control	ελέγχω
to soften	μαλακώνω
to oversee	παραβλέπω
to corrupt	διαφθείρω
ambition	η φιλοδοξία
socket	η πρίζα
heroine	η ηρωίδα
honesty	η τιμιότητα
muse	η μούσα
stroll	η βόλτα
severity	η αυστηρότητα
label	η ετικέτα
circumference	η περιφέρεια
cramp	η κράμπα
amazed	έκπληκτος
unlimited	απεριόριστος
impregnable	απόρθητος
lower	χαμηλότερος
unpleasant	δυσάρεστος
toward	προς
tenth	δέκατος
unjust	άδικος
uncivilized	απολίτιστος
complex	πολύπλοκος
ownership	η ιδιοκτησία
retribution	η τιμωρία
forceps	η λαβίδα
file	η λίμα
anchor	η άγκυρα
wisdom	η σοφία
card	η κάρτα
apprenticeship	η μαθητεία
wheel	η ρόδα
etiquette	η εθιμοτυπία
to blaspheme	βλασφημώ
to date	χρονολογώ
to penalize	τιμωρώ
to braze	συγκολλώ
to secede	αποσκιρτώ
to delimit	οροθετώ
to reanimate	αναζωογονώ
to avail	ωφελώ
to gasp	αγκομαχώ
to thrive	ευδοκιμώ
fly	η μύγα
pumpkin	η κολοκύθα
inertia	η αδράνεια
hump	η καμπούρα
magic	η μαγεία
seal	η φώκια
lace	η δαντέλα
benefit	η ωφέλεια
curiosity	η περιέργεια
embarrassment	η αμηχανία
flowing	ρέων
unhappily	δυστυχισμένα
recently	πρόσφατα
elsewhere	αλλού
discreetly	διακριτικά
resolutely	αποφασισμένα
officially	επίσημα
fitting	αρμόζων
childishly	παιδιαστικά
purely	καθαρά
jam	η μαρμελάδα
custom	η πελατεία
sling	η σφεντόνα
ribbon	η κορδέλα
unemployment	η ανεργία
badge	η κονκάρδα
disability	η αναπηρία
stocking	η κάλτσα
gale	η θύελλα
slipper	η παντόφλα
to flourish	ανθίζω
to perish	πεθαίνω
to intercept	ανακόπτω
to suppress	καταστέλλω
to protect	προστατεύω
to gnaw	ροχανίζω
to adapt	προσαρμόζω
to lack	λείπω
to adore	λατρεύω
to ripen	ωριμάζω
apoplexy	η αποπληξία
debauchery	η ακολασία
glue	η κόλλα
guess	η εικασία
bomb	η βόμβα
pan	η κατσαρόλα
rhyme	η ομοιοκαταληξία
tie	η γραβάτα
redness	η κοκκινάδα
plug	η τάπα
sparing	φειδωλός
close	κοντός
vaulted	θολωτός
aesthetic	αισθητικός
curt	κοφτός
bashful	ντροπαλός
hairy	μαλλιαρός
venturesome	τολμηρός
mighty	δυνατός
supernatural	υπερφυσικός
libel	η συκοφαντία
aggression	η επιθετικότητα
cavity	η κοιλότητα
prank	η φάρσα
resemblance	η ομοιότητα
looseness	η χαλαρότητα
splinter	η σχίζα
commission	η προμήθεια
dummy	η πιπίλα
craziness	η τρέλα
to gauge	μετρώ
to reflect	αντανακλώ
to attest	μαρτυρώ
to bid	πλειοδοτώ
to pluck	μαδώ
to squash	ζουλώ
to deplete	εξαντλώ
to shudder	ριγώ
to dissatisfy	δυσαρεστώ
to irk	ενοχλώ
dowry	η προίκα
stoat	η νυφίτσα
distrust	η δυσπιστία
irony	η ειρωνεία
hut	η καλύβα
fathom	η οργία
purity	η αγνότητα
agitation	η ανησυχία
specialty	η ειδικότητα
sleeplessness	η αϋπνία
diligently	φιλόπονα
stealthily	λαθραία
beautifully	όμορφα
ignorant	αγνών
fiercely	άγρια
copiously	άφθονα
repeatedly	επανειλημμένα
sweetly	γλυκά
stealthy	λαθραία
particularly	ειδικά
tide	η παλίρροια
infidelity	η απιστία
revolt	η ανταρσία
gear	η ταχύτητα
arbitrariness	η αυθαιρεσία
mange	η ψώρα
bias	η μεροληψία
buttonhole	η κουμπότρυπα
notation	η σημειογραφία
dysentery	η δψσεντερία
to shove	σπρώχνω
to supplicate	ικετεύω
to exasperate	εξοργίζω
to cease	παύω
to pollute	μολύνω
to cheapen	φτηναίνω
to abstain	απέχω
to disentangle	ξεμπερδεύω
to clasp	σφίγγω
to proclaim	προκηρύσσω
bristle	η γουρουνότριχα
bravery	η γενναιότητα
personality	η προσωπικότητα
farmhouse	η αγροικία
ribaldry	η αισχρολογία
cabin	η καμπίνα
arbitration	η διατησία
rack	η σχάρα
pitfall	η παγίδα
philology	η φιλολογία
extensive	εκτεταμένος
guiltless	αθώος
rapid	γρήγορος
unaware	ανήξερος
untimely	πρόωρος
woollen	μάλλινος
untroubled	γαλήνιος
unwilling	απρόθυμος
contemporary	σύγχρονος
outermost	εξώτατος
make	η μάρκα
pneumonia	η πνευμονία
trap	η παγίδα
aid	η βοήθεια
salad	η σαλάτα
censorship	η λογοκρισία
firmness	η σταθερότητα
stability	η σταθερότητα
loveliness	η ωραιότητα
air	η ατμόσφαιρα
to appraise	εκτιμώ
to champ	ανυπομονώ
to waken	ξυπνώ
to apprise	γνωστοποιώ
to scrutinize	διερευνώ
to bridle	χαλιναγωγώ
to overwhelm	κατανικώ
to repeal	ανακαλώ
to boom	βομβώ
to blab	ακριτολογώ
to appraise	εκτιμώ
to champ	ανυπομονώ
to waken	ξυπνώ
to apprise	γνωστοποιώ
to scrutinize	διερευνώ
to bridle	χαλιναγωγώ
to overwhelm	κατανικώ
to repeal	ανακαλώ
to boom	βομβώ
to blab	ακριτολογώ
board	η σανίδα
company	η παρέα
morsel	η μπουκιά
mention	η αναφορά
soot	η καπνιά
offering	η προσφορά
transport	η μεταφορά
sabotage	η δολιοφθορά
transportation	η μεταφορά
affliction	η συμφορά
wonderfully	θαυμάσια
shamelessly	αναίσχυντα
forcibly	βιαία
savagely	άγρια
leisurely	ήρεμα
headlong	ορμητικά
wretchedly	δυστυχισμένα
foolishly	ανόητα
opinionated	ισχυρογνώμων
covetous	εποφθαλμιών
salve	η αλοιφή
commandment	η εντολή
slot	η σχισμή
persuasion	η πειθώ
bark	το γάβγισμα
acquaintance	ο γνωστός
codex	ο κώδικας
sergeant	ο λοχίας
fiend	ο δαίμονας
saboteur	ο δολιοφθορέας
to endow	προικίζω
to condemn	καταδικάζω
to bet	στοιχηματίζω
to abbreviate	συντομεύω
to shiver	τρέμω
to bewitch	μαγεύω
to amaze	εκπλήσσω
to tease	πειράζω
to diminish	μειώνω
to dismember	διαμελίζω
bleak	σκοτεινός
autumnal	φθινοπωρινός
destructive	καταστροφικός
criminal	εγκληματικός
barbaric	βαρβαρικός
curved	καμπυλωτός
brotherly	αδελφικός
lame	κουτσός
passionate	θερμός
maritime	ναυτικός
to famish	πεινώ
to nip	τσιμπώ
to grope	ψηλαφώ
to avow	ομολογώ
to cling	κολλώ
to ossify	οστεοποιώ
to authorize	εξουσιοδοτώ
to backbite	κακολογώ
to emigrate	αποδημώ
to ramble	πολυλογώ
tonight	απόψε
coldly	ψυχρά
wheezy	ασθμαίνων
deceased	αποθανών
faintly	αμυδρά
briefly	σύντομα
wherever	οπουδήποτε
askew	στραβά
frankly	ειλικρινά
tearfully	δακρυσμένα
to dig	σκάβω
to spell	συλλαβίζω
to prolong	παρατείνω
to refine	ραφινάρω
to arouse	ξεσηκώνω
to cry	κλαίω
to brag	κομπάζω
to dictate	υπαγορεύω
to sob	σιγοκλαίω
to fast	νηστεύω
wooden	ξύλινος
soggy	μουσκεμένος
occupied	απασχολημένος
inattentive	απρόσεκτος
everlasting	αιώνιος
content	ικανοποιημένος
tasteless	άνοστος
gentle	ήπιος
lawful	νόμιμος
rickety	ξεχαρβαλωμένος
to kick	κλωτσώ
to combat	καταπολεμώ
to defraud	υπεξαιρώ
to stereotype	τυποποιώ
to falsify	πλαστογραφώ
to ransack	λεηλατώ
to strafe	σφυροκοπώ
to straggle	βραδυπορώ
to withhold	κατακρατώ
to hanker	λαχταρώ
amazingly	εκπλητικά
newly	πρόσφατα
carelessly	απρόσεκτα
lazily	οκνηρά
leaky	δαιρρέων
becoming	αρμόζων
precisely	ακριβέστατα
candidly	ειλικρινά
rapidly	γοργά
correctly	σωστά
to nullify	μηδενίζω
to start	αρχίζω
to uncoil	ξετυλίγω
to ascertain	εξακριβώνω
to possess	κατέχω
to extricate	ξεμπερδεύω
to infuriate	εξοργίζω
to coax	καλοπιάνω
to persist	επιμένω
to liken	παρομοιάζω
kingly	βασιλικός
thousandth	χιλιοστός
arctic	αρκτικός
hasty	βιαστικός
journalistic	δημοσιογραφικός
magical	μαγικός
deceitful	απατηλός
thrilling	συναρπαστικός
hellish	διαβολικός
domineering	δεσποτικός
to reconsider	αναθεωρώ
to outclass	υπερτερώ
to outdo	υπερτερώ
to becalm	ακινητοποιώ
to rearrange	διευθετώ
to explore	εξερευνώ
to shirk	φυγοπονώ
to harry	παρενοχλώ
to dunk	βουτώ
to undervalue	υποτιμώ
unintentionally	άθελα
preferably	προτιμώτερα
unwillingly	απρόθυμα
urgently	επείγων
steadily	σταθερά
contemptuously	περιφρονητικά
either	είτε
appropriately	κατάλληλα
hotly	θερμά
cleanly	καθαρά
to sift	κοσκινίζω
to obliterate	εξολοθρεύω
to undermine	υποσκάπτω
to gird	περιζώνω
to nominate	χρίω
to equip	εξοπλίζω
to injure	τραυματίζω
to unearth	ξεσκεπάζω
to cherish	λατρεύω
to wrestle	παλεύω
dusty	σκονισμένος
great	μεγάλος
virtuous	ενάρετος
earnest	σοβαρός
unripe	ανώριμος
crafty	πανούργος
inclusive	μπεριλαμβανόμενο
miscellaneous	ποικίλος
accustomed	συνηθισμένος
permanent	μόνιμος
to outlast	επιζώ
to computerize	υπολογιστικοποιώ
to outlive	επιζώ
to condone	συγχωρώ
to gambol	χοροπηδώ
to enfranchise	χειραφετώ
to recant	αναιρώ
to applaud	χειροκροτώ
to spay	στειροποιώ
to grade	βαθμολογώ
approximately	περίπου
loosely	χαλαρά
initially	αρχικά
nightly	νυχτερινά
heavily	βαριά
intentionally	εσκεμμένα
strikingly	χτυπητά
superficially	επιφανειακά
callously	ασυγκίνητα
awry	στραβά
to admonish	επιπλήττω
to spread	απλώνω
to confound	συγχέω
to spill	χύνω
to expose	εκθέτω
to spin	στριφογυρίζω
to mince	ξιλοκόβω
to perspire	ιδρώνω
to intersect	διατέμνω
to hasten	επισπεύδω
feathered	φτερωτός
shady	σκιερός
scriptural	βιβλικός
mythical	θρυλικός
antique	παλιός
thievish	κλεπτικός
misleading	παραπλανητικός
swarthy	μελαψός
lonely	μοναχικός
mute	μουγγός
to compel	εξαναγκάζω
to instruct	διδάσκω
to edit	εκδίδω
to confirm	επιβεβαιώνω
to uphold	υπερασπίζω
to slacken	λασκάρω
to distinguish	διακρίνω
to cross	τέμνω
to uproot	ξεριζώνω
to straighten	ευθυγραμμίζω
lesser	ελάσσων
swimmingly	εύκολα
casually	ξέγνοιαστα
originally	αρχικά
any	καθόλου
wishful	επιθυμών
outrageously	εξωφρενικά
faultlessly	άψογα
flagrantly	κατάφορα
delightfully	γοητευτικά
to crush	συντρίβω
to preach	κηρύσσω
to flash	λάμπω
to strain	τεντώνω
to recover	αναρρώνω
to polish	γυαλίζω
to provide	παρέχω
to involve	εμπλέκω
to blossom	ανθίζω
to liberate	απελευθερώνω
ancient	αρχαίος
restless	ανήσυχος
spicy	πικάντικος
prepared	έτοιμος
intended	εσκεμμένος
needed	αναγκαίος
foremost	πρώτιστος
changeable	ευμετάβλητος
listless	άτονος
frightened	φοβισμένος
to contradict	αντιφάσκω
to wean	απογαλακτίζω
to cancel	ακυρώνω
to satirize	σατιρίζω
to manage	διευθύνω
to carve	σκαλίζω
to moisten	υγραίνω
to rend	περιζώνω
to snore	ροχαλίζω
to beckon	γνέφω
afloat	επιπλέων
flippantly	επιπόλαια
thereabouts	περίπου
generously	γενναιόδωρα
fondly	στοργικά
moderately	μέτρια
afterwards	μετά
deceitfully	απατηλά
destructively	καταστροφικά
graciously	χαριτωμένα
to subject	υποτάσσω
to erode	διαβιβρώσκω
to erase	διαγράφω
to accustom	συνηθίζω
to whitewash	ασπρίζω
to verify	επαληθεύω
to affect	επηρεάζω
to enrich	εμπλουτίζω
to astound	εκπλήσσω
to decapitate	αποκεφαλίζω
vile	αισχρός
fiery	φλογερός
known	γνωστός
tiny	μικροσκοπικός
showery	βροχερός
uncooked	ωμός
dusky	μελαψός
puny	ασθενικός
written	γραπτός
western	δυτικός
to soil	λερώνω
to purge	καθαρίζω
to scream	στριγγλίζω
to extinguish	σβήνω
to match	ταιριάζω
to encircle	περικυκλώνω
to deride	χλευάζω
to congratulate	συγχαίρω
to consume	καταναλίσκω
to rob	κλέβω
laboriously	επίπονα
vitally	ζωτικά
fairly	αρκετά
boorishly	άξεστα
guiltily	ένοχα
abruptly	ξαφνικά
disloyally	άπιστα
staring	ατενίζων
cruelly	σκληρά
haughtily	αγερώχα
to induce	επάγω
to solve	λύνω
to retaliate	ανταποδίδω
to confine	περιορίζω
to tighten	σφίγγω
to befit	αρμόζω
to uplift	ανυψώνω
to knead	μαλάζω
to sulk	κατσουφιάζω
to humiliate	ταπεινώνω
brief	σύντομος
undoubted	αναμφισβήτητος
synonymous	συνώνυμος
odorous	εύοσμος
dried	αποξηρωμένος
gradual	βαθμιαίος
inhabited	κατοικημένος
commendable	αξιέπαινος
overflowing	ξέχειλος
immemorial	αμνημόνευτος
to split	χωρίζω
to abase	ταπεινώνω
to color	χρωματίζω
to bewilder	ζαλίζω
to alleviate	καταπραϋνω
to cheer	ζητωκραυγάζω
to ascribe	αποδίδω
to transform	μετατρέπω
to singe	τσουροφλίζω
to clarify	αποσαφηνίζω
sleek	στιλπνός
mealy	ωχρός
bright	λαμπερός
removable	κινητός
theological	θεωλογικός
remedial	διορθωτικός
slippery	γλιστερός
wary	επιφυλακτικός
sweeping	σαρωτικός
brisk	γοργός
to pour	χύνω
to relieve	ανακουφίζω
to eject	εκτοξεύω
to moderate	μετριάζω
to discern	διακρίνω
to subjugate	υποτάσσω
to overeat	παρατρώω
to lodge	στεγάζω
to stain	λεκιάζω
to excel	αριστεύω
prior	προηγούμενος
unharmed	άθικτος
downcast	άθυμος
fertile	εύκαρπος
unquestionable	αναφμισβήτητος
else	άλλος
unpardonable	ασυγχώρητος
larger	μεγαλύτερος
starry	έναστρος
famished	πεινασμένος
to impair	βλάπτω
to wet	βρέχω
to elect	εκλέγω
to taunt	χλευάζω
to gape	χάσκω
to subdue	καταστέλλω
to topple	ανατρέπω
to frustrate	ματαιώνω
to define	προσδιορίζω
to purify	εξαγνίζω
phonetic	φωνητικός
proper	σωστός
bearable	ανεκτός
neighboring	γειτωνικός
revengeful	εκδικητικός
disastrous	καταστροφικός
spotted	πιτσιλωτός
sixtieth	εξηκοστός
scaly	λεπιδωτός
theoretical	θεωρετικός
to unbend	χαλαρώνω
to agitate	ταράζω
to reread	ξαναδιαβάζω
to incur	επισύρω
to inclose	εσωκλείω
to scold	κατσαδιάζω
to secrete	εκκρίνω
to excite	εξάπτω
to withstand	αντέχω
to empty	αδειάζω
born	γεννημένος
superior	ανώτερος
rustic	αγροίκος
untiring	ακούραστος
peculiar	περίεργος
heedless	απερίσκεπτος
flighty	επιπόλαιος
twisted	διαστρεβλωμένος
laden	φορτωμένος
unflagging	ακούραστος
to crease	τσαλακώνω
to inflame	εξάπτω
to irritate	εκνευρίζω
to smear	αλείφω
to thieve	κλέβω
to acknowledge	αναγνωρίζω
to stumble	σκοντάφτω
to wring	στίβω
to offend	προσβάλλω
to ooze	διαρρέω
vindictive	εκδικητικός
rounded	στρογγυλός
nourishing	θρεπτικός
mutinous	στασιαστικός
respected	σεβαστός
watery	νερουλός
masterful	αριστοτεχνικός
definite	οριστικός
blackish	μαυρωπός
sturdy	γερός
to falter	τρεκλίζω
to inter	θάβω
to appease	κατευνάζω
to depict	απεικονίζω
to repress	καταπνίγω
to enliven	ζωντανεύω
to abide	εμμένω
to brutalize	αποκτηνώνω
to predict	προβλέπω
to inspire	εμπνέω
unlucky	άτυχος
earthly	γήινος
unforgiving	ασυγχώρητος
settled	νοικοκυρεμένος
seasonable	επίκαιρος
ruddy	κατακόκκινος
silky	μεταξένιος
married	παντρεμένος
senseless	παράλογος
unconcerned	ανέμελος
to excommunicate	αφορίζω
to lighten	αστράφτω
to dedicate	αφιερώνω
to sculpt	σκαλίζω
to digress	ξεφεύγω
to sever	αποκόπτω
to trail	ανιχνεύω
to embody	ενσωματώνω
to whinny	χλιμαντρίζω
to absolve	απαλλάσσω
grievous	θλιβερός
eastern	ανατολικός
lyrical	λυρικός
twentieth	εικοστός
gloomy	σκοτεινός
disgraceful	αισχρός
impoverished	φτωχός
respectable	σεβαστός
fixed	σταθερός
thrifty	φειδωλός
to sail	πλέω
to unhook	απαγγιστρώνω
to inscribe	επιγράφω
to examine	εξετάζω
to attach	συνδέω
to encamp	στρατοπεδεύω
to devastate	καταστρέφω
to crawl	μπουσουλάω
to scorch	τσουρουφλίζω
to decrease	μειώνω
stark	απόλυτος
revolving	περιστρεφόμενος
rosy	ρόδινος
unruly	άτακτος
boyishly	αγορίστικος
appropriate	κατάλληλος
fussy	μικρόλογος
multifarious	πολύπλευρος
unfruitful	άκαρπος
level	επίπεδος
to immerse	βυθίζω
to meddle	παρεμβαίνω
to conceive	συλλαμβάνω
to soak	μουσκεύω
to befall	συμβαίνω
to revile	βρίζω
to scatter	σκορπίζω
to hoe	σκαλίζω
to appoint	ορίζω
to overrule	ακυρώνω
dazzling	εκτυφλωτικός
bare	γυμνός
stylish	κομψός
strict	αυστηρός
smart	κομψός
righteous	ηθικός
moist	υγρός
devilish	διαβολικός
decisive	αποφασιστικός
reddish	κοκκινωπός
to flirt	φλερτάρω
to crumble	θρυψαλιάζω
to transport	μεταφέρω
to stow	επανοθηκεύω
to deaden	νεκρώνω
to defer	αναβάλλω
to be lacking	λείπω
to bisect	διατέμνω
to unfasten	ξεκουμπώνω
to wheedle	κολακεύω
merciful	φιλεύσπλαχνος
allowed	επιτρεπόμενος
immature	ανώριμος
fickle	ευμετάβλητος
hazardous	επικίνδυνος
tawny	καστανόξανθος
elaborate	περίπλοκος
jaunty	ξένοιαστος
remaining	υπόλοιπος
untainted	αμίαντος
to imbibe	πίνω
to insulate	απομονώνω
to extort	εκβιάζω
to tackle	αντιμετωπίζω
to indoctrinate	εμποτίζω
to pare	ξακρίζω
to unloose	χαλαρώνω
to shun	αποφεύγω
to locate	εντοπίζω
to plait	πλέκω
cunning	πονηρός
crooked	γαμψός
economical	οικονομικός
distant	μακρινός
slim	λεπτός
sacred	ιερός
natural	φυσιολογικός
orphan	ορφανός
annoying	ενοχλητικός
athletic	αθλητικός
to smooth	λειαίνω
to heap	συσσωρεύω
to entertain	διασκεδάζω
to loiter	χαζεύω
to cheat	κλέβω
to endue	προικίζω
to perplex	σαστίζω
to pilfer	κλέβω
to quell	καταπνίγω
to totter	τρικλίζω
dizzy	ζαλισμένος
shapeless	άμορφος
trustful	έμπιστος
silvery	ασημένιος
merciless	άσπλαχνος
sweaty	ιδρωμένος
staunch	αφοσιωμένος
unchanging	αμετάβλητος
swollen	πρησμένος
successful	πετυχημένος
to squeak	τρίζω
to alight	κατεβαίνω
to gild	επιχρυσώνω
to counsel	συμβουλεύω
to cremate	αποτεφρώνω
to flutter	τρέμω
to argue	καυγαδίζω
to evaporate	εξατιμίζω
to interweave	συνυφαίνω
to plan	σχεδιάζω
within	εντός
insane	τρελός
outer	εξωτερικός
deceptive	απατηλός
moving	συγκινητικός
rural	αγροτικός
special	ειδικός
faulty	ελαττωματικός
civic	αστικός
amazing	εκπλητικός
to tingle	τσούζω
to exceed	υπερβαίνω
to sprinkle	ραντίζω
to mould	πλάθω
to crack	ραγίζω
to wriggle	στριφογυρίζω
to trickle	σταλάζω
to analyze	αναλύω
to remit	εμβάζω
to aerate	εξαερίζω
youthful	νέος
almighty	παντοδύναμος
barefoot	ξυπόλητος
blameless	αθώος
painstaking	φιλόπονος
valiant	γενναίος
disobedient	ανυπάκοος
fourfold	τετραπλάσιος
irate	θυμωμένος
shrunken	συρικνωμένος
to extend	εκτείνω
to heed	προσέχω
to enrage	εξοργίζω
to convalesce	αναρρώνω
to perplex	σαστίζω
to adhere	εμμένω
to persecute	καταδιώκω
to hug	αγγαλιάζω
to roost	κουρνιάζω
to skip	παραλείπω
entertaining	διασκεδαστικός
mindful	προσεκτικός
acceptable	δεκτός
grasping	αρπακτικός
immoderate	υπερβολικός
boring	βαρετός
round	στρογγυλός
slanderous	συκοφαντικός
final	τελικός
distinct	ξεχωριστός
to clot	πήζω
to deform	παραμορφώνω
to teem	βρίθω
to repay	αναπληρώνω
to worsen	χειροτερεύω
to unbar	ξεαμπαρώνω
to protrude	προεξέχω
to imprison	φυλακίζω
to scare	φοβίζω
to domesticate	εξημερώνω
synchronous	σύγχρονος
woolly	μάλλινος
sparkling	σπινθηροβόλος
dexterous	επιδέξιος
prime	πρώτιστος
fruitless	άκαρπος
gullible	μωρόπιστος
unsuited	αταιρίαστος
lean	άπαχος
unhappy	δυστυχισμένος
to stare	ατενίζω
to unclose	ανοίγω
to educate	εκπαιδεύω
to splice	ματίζω
to articulate	αρθρώνω
to double	διπλώνω
to forfeit	εκπίπτω
to infect	μολύνω
to nurture	τρέφω
to cower	ζαρώνω
lofty	υψηλός
blond	ξανθός
musical	μουσικός
probable	πιθανός
shining	λαμπερός
stable	σταθερός
speedy	γοργός
hidden	κρυφός
lucky	τυχερός
domestic	οικιακός
to coagulate	πήζω
to disarm	αφοπλίζω
to darn	μαντάρω
to disqualify	αποκλείω
to bleed	ματώνω
to ignite	ανάβω
to anoint	χρίω
to inhale	εισπνέω
to rebuke	επιπλήττω
to lessen	μειώνω
stale	μπαγιάτικος
expert	έμπειρος
boyish	αγορίστικος
unsure	αβέβαιος
guilty	ένοχος
casual	ανεπίσημος
readable	αναγνωσίμος
unmanageable	απείθαρχος
uninjured	σώος
unswerving	ακλόνητος
to buckle	στραβώνω
to widen	φαρδαίνω
to undo	ξεκουμπώνω
to occur	συμβαίνω
to exhilarate	συναρπάζω
to cringe	ζαρώνω
to constrict	περιορίζω
to persevere	επιμένω
to squeal	στριγγλίζω
to adulterate	νοθεύω
internal	εσωτερικός
financial	οικονομικός
favorable	ευνοϊκός
shrewd	διορατικός
personal	προσωπικός
severe	σοβαρός
municipal	δημοτικός
naked	γυμνός
affectionate	στοργικός
intellectual	διανοητικός
to abridge	συντομεύω
to immortalize	αποθανατίζω
to bud	μπουμπουκιάζω
to mumble	μουρμουρίζω
to deafen	κουφαίνω
to bode	προμηνύω
to store	αποθηκεύω
to organize	οργανώνω
to browse	ξεφυλλίζω
to ebb	παρακμάζω
smaller	μικρότερος
unchecked	ανεξέλεγχτος
anxious	ανήσυχος
unhurt	σώος
godless	άθεος
undesirable	ανεπιθύμητος
chained	αλυσοδεμένος
missing	αγνοούμενος
eatable	φαγώσιμος
fearless	ατρόμητος
to overspread	σκεπάζω
to record	εγγράφω
to embitter	πικραίνω
to lop	αποκόβω
to stimulate	διαγείρω
to replenish	εφοδιάζω
to estrange	αποξενώνω
to inundate	πλημμυρίζω
to lick	γλείφω
to browbeat	εκφοβίζω
active	ενεργετικός
indecisive	διστακτικός
pensive	σκεπτικός
frequent	συχνός
charming	γοητευτικός
vigorous	σφριγηλός
loyal	πιστός
furtive	κρυφός
truthful	αληθινός
solemn	σοβαρός
to defile	βεβηλώνω
to wipe	σκουπίζω
to overturn	αναποδογυρίζω
to desecrate	βεβηλώνω
to stride	βαδίζω
to ameliorate	βελτιώνω
to throb	πάλλω
to seal	σφραγίζω
to effervesce	βράζω
to gallop	καλπάζω
shattered	θρυμματισμένος
conceited	επαρμένος
hopeful	ελπιδοφόρος
starving	πεινασμένος
lifeless	άψυχος
resolute	αποφασισμένος
official	επίσημος
resolved	αποφασισμένος
tried	δοκιμασμένος
forbidden	απαγορευμένος
to impoverish	φτωχαίνω
to complicate	περιπλέκω
to lengthen	μακραίνω
to snap	αρπάζω
to divert	εκτρέπω
to prowl	τριγυρίζω
to overthrow	ανατρέπω
to palpitate	πάλλω
to beset	περικυκλώνω
to spit	φτύνω
courteous	ευγενικός
excessive	υπερβολικός
national	εθνικός
harsh	σκληρός
local	τοπικός
bad	κακός
ideal	ιδανικός
singular	ενικός
exterior	εξωτερικός
thorough	εξονυχιστικός
to ensnare	παγιδεύω
to strew	στρώνω
to compose	συνθέτω
to allot	κατανέμω
to capture	αιχμαλωτίζω
to pant	λαχανιάζω
to mollify	κατευνάζω
to thaw	ξεπαγώνω
to raze	ισοπεδώνω
to steep	εμβαπτίζω
soulless	άψυχος
unmerited	αδικαιολόγητος
flawless	άψογος
done	τελειωμένος
unfit	ακατάλληλος
unscrupulous	αδίστακτος
formless	άμορφος
diligent	φιλόπονος
copious	άφθονος
graceless	άχαρος
to sear	ξηραίνω
to attain	κατορθώνω
to embellish	εξωραϊζω
to disinfect	απολυμαίνω
to equalize	ισοφαρίζω
to certify	βεβαιώνω
to gleam	λάμπω
to hire	νοικιάζω
to assume	υποθέτω
to discourage	αποθαρρύνω
horrible	φρικτός
central	κεντρικός
consecutive	διαδοχικός
tidy	καθαρός
typical	τυπικός
scientific	επιστημονικός
mechanical	μηχανικός
atomic	ατομικός
exceptional	εξαιρετικός
divine	θεϊκός
to disrupt	διακόπτω
to beguile	μαγεύω
to rattle	κροταλίζω
to obstruct	εμποδίζω
to transcribe	μεταγράφω
to goad	κεντρίζω
to inure	εθίζω
to render	αποδίδω
to quicken	επιταχύνω
to warm	θερμαίνω
humane	ανθρώπινος
decrepit	ερειπωμένος
displeasing	δυσάρεστος
steep	απότομος
fretful	δυσαρεστημένος
higher	υψηλότερος
tested	δοκιμασμένος
talkative	φλύαρος
whitewashed	ασπρισμένος
unutterable	ανείπωτος
to entice	δελεάζω
to seethe	βράζω
to parry	αποκρούω
to slay	φονεύω
to disprove	ανασκευάζω
to vaccinate	εμβολιάζω
to scrape	ξύνω
to disappoint	απαγοητεύω
to splash	πιτσιλάω
to validate	επικυρώνω
which	ποιός
golden	χρυσός
patient	υπομονετικός
imaginary	φανταστικός
future	μελλοντικός
elegant	κομψός
dramatic	δραματικός
raw	ωμός
artificial	τεχνητός
religious	θρησκευτικός
to participate	συμμετέχω
to dye	βάφω
to stuff	παραγεμίζω
to incline	κλίνω
to hew	λαξεύω
to unroll	ξετυλίγω
to foretell	προλέγω
to beautify	καλλωπίζω
to cajole	καλοπιάνω
to denote	σημαίνω
mistaken	λανθασμένος
accomplished	ολοκληρωμένος
bearded	μουσάτος
thunderstruck	εμβρόντητος
withered	μαραμένος
extended	εκτεινόμενος
undeserved	αδικαιολόγητος
monthly	μηναίος
blazing	φλεγόμενος
sterile	αποστειρομένος
to fell	κόβω
to emphasize	τονίζω
to represent	αντιπροσωπεύω
to scour	τρίβω
to seep	διαρρέω
to segregate	διαχωρίζω
to maim	σακετεύω
to entrench	περιχαρακώνω
to lubricate	λιπαίνω
to depose	εκθρονίζω
professional	επαγγελματικός
troublesome	ενοχλητικός
paternal	πατρικός
mortal	θνητός
alive	ζωντανός
moral	ηθικός
mental	πνευματικός
considerable	σημαντικός
visible	ορατός
half	μισός
to scourge	μαστιγώνω
to titillate	ερεθίζω
to accelerate	επιταξύνω
to deprecate	αποδοκιμάζω
to jail	φυλακίζω
to confront	αντιμετωπίζω
to scrabble	ορνιθοσκαλίζω
to intrude	παρεισφέρω
to pose	ποζάρω
to squint	αλληθωρίζω
equitable	δίκαιος
adamant	ανένδοτος
spotless	πεντακάθαρος
skilful	επιδέξιος
ajar	μισάνοιχτος
bigoted	μισαλλόδοξος
variegated	διαφοροποιημένος
exempt	απαλλαγμένος
uncomfortable	άβολος
timely	επίκαιρος
to glare	αγριοκοιτάζω
to pave	πλακοστρώνω
to depress	καταθλίβω
to affirm	βεβαιώνω
to ferment	αναβράζω
to mature	ωριμάζω
to accost	πλησιάζω
to filch	ξαφρίζω
to output	παράγω
to shrivel	ζαρώνω
kind	ευγενικός
aggressive	επιθετικός
sudden	ξαφνικός
metallic	μεταλλικός
careful	προσεκτικός
silly	χαζός
cubic	κυβικός
discreet	διακριτικός
regular	κανονικός
civil	αστικός
to stupefy	αποβλακώνω
to conjugate	κλίνω
to unfreeze	ξεπαγώνω
to heighten	υψώνω
to suckle	θηλάζω
to construct	κατασκευάζω
to dazzle	θαμπώνω
to cool	κρυώνω
to transcribe	μεταγράφω
to connect	συνδέω
wrinkled	ζαρωμένος
unsightly	άσχημος
lopsided	ανισόρροπος
uninhabited	ακατοίκητος
inexperienced	άπειρος
putrid	σάπιος
void	άδειος
confident	πεπεισμένος
improvident	σπάταλος
scarlet	άλικος
to efface	εξαλείφω
to highlight	τονίζω
to shuffle	ανακατεύω
to tilt	γέρνω
to consign	αποστέλλω
to contract	συστέλλω
to knit	πλέκω
to glorify	δοξάζω
to erect	ορθώνω
to transgress	παραβιάζω
slow	αργός
political	πολιτικός
cool	δροσερός
delicate	λεπτός
bitter	πικρός
admirable	θαυμαστός
hateful	μισητός
banal	πεζός
bald	φαλακρός
obscure	σκοτεινός
to transmit	μεταδίδω
to substantiate	τεκμηριώνω
to belie	διαψεύδω
to crackle	τρίζω
to unlock	ξεκλειδώνω
to sicken	αηδιάζω
to rot	σαπίζω
to overcast	σκοτεινιάζω
to dislocate	εξαρθρώνω
to unite	ενώνω
incredible	απίστευτος
savage	άγριος
tattered	κουρελιασμένος
controversial	αμφιλεγόμενος
bleeding	ματωμένος
pliable	εύκαμπτος
tearful	δακρυσμένος
aged	ηλικιωμένος
eloquent	εύγλωττος
blatant	κατάφωρος
to relinquish	εγκαταλείπω
to mate	ζευγαρώνω
to protract	παρατείνω
to tutor	διδάσκω
to bestrew	στρώνω
to ease	διευκολύνω
to compact	συμπιέζω
to jab	μπήγω
to lunch	γευματίζω
to belittle	μειώνω
technical	τεχνικός
sympathetic	συμπονετικός
sordid	ελεεινός
warm	ζεστός
intimate	στενός
lovable	αγαπητός
royal	βασιλικός
maternal	μητρικός
piercing	διαπεραστικός
apparent	φαινομενικός
to overdo	παρακάνω
to unmask	ξεσκεπάζω
to dote	λατρεύω
to elate	συναρπάζω
to constrain	εξαναγκάζω
to creak	τρίζω
to devour	καταβροχθίζω
to sift	κοσκινίζω
to elongate	επιμηκύνω
to profane	βεβηλώνω
damaged	χαλασμένος
frozen	παγωμένος
enraged	εξοργισμένος
drowsy	νυσταγμένος
burning	φλεγόμενος
steely	ατσάλινος
dutiful	υπάκουος
dainty	φίνος
specious	εύσχημος
bloodless	αναίμακτος
to flail	δέρνω
to commence	αρχίζω
to summarize	συνοψίζω
to hoot	σκούζω
to destine	προσδιορίζω
to unpack	ξεπακετάρω
to emasculate	ευνουχίζω
to enlighten	διαφωτίζω
to puff	λαχανιάζω
to babble	κελαρύζω
worldly	κοσμικός
loose	χαλαρός
social	κοινωνικός
military	στρατιωτικός
cowardly	δειλός
sharp	κοφτερός
faithful	πιστός
sweet	γλυκός
silent	σιωπηλός
childish	παιδιαστικός
to malign	διαβάλλω
to impute	καταλογίζω
to corrugate	ζαρώνω
to flex	κάμπτω
to besmirch	κηλιδώνω
to embolden	ενθαρρύνω
to overlap	επικαλύπτω
to skim	ξαφρίζω
to overdraw	υπερβάλλω
to exude	εκκρίνω
paltry	ασήμαντος
undisturbed	ανενόχλητος
laughable	γελοίος
stinking	βρώμικος
flippant	επιπόλαιος
twelfth	δωδέκατος
vicarious	υποκατάστατος
smoky	καπνισμένος
deformed	παραμορφωμένος
unbending	αλύγιστος
to convert	μετατρέπω
to snatch	αρπάζω
to pitch	ρίπτω
to preside	προεδρεύω
to reconcile	συμφιλιώνω
to mew	σιγονιαουρίζω
to implant	εμφυτεύω
to betroth	αρραβωνιάζω
to howl	ουρλιάζω
to unscrew	ξεβιδώνω
painful	οδυνηρός
own	δικός
raucous	βραχνός
prudent	σοφός
double	διπλός
provisional	προσωρινός
powerful	δυνατός
solid	στερεός
obliging	εξυπηρετικός
reasonable	λογικός
to outflank	υπερφαλαγγίζω
to flog	μαστιγώνω
to inflect	κλίνω
to dung	κοπρίζω
to await	αναμένω
to dull	αμβλύνω
to toss	ρίχνω
to comprehend	καταλαβαίνω
to flush	κοκκινίζω
to crouch	ανακουρκουδίζω
immovable	ακίνητος
unfaithful	άπιστος
spiteful	μνησίκακος
lousy	ψειριασμένος
worried	ανήσυχος
repentant	μετανιωμένος
scabby	ψωραλέος
steadfast	ακλόνητος
willing	πρόθυμος
reckless	παράτολμος
to redouble	αναδιπλασιάζω
to unseat	ανατρέπω
to tender	υποβάλλω
to override	υπερισχύω
to appall	εκφοβίζω
to scrap	διαλύω
to gloat	επιχαίρω
to squirm	στριφογυρίζω
to disallow	ακυρώνω
to preclude	αποκλείω
particular	ειδικός
loud	δυνατός
masculine	αρσενικός
normal	κανονικός
cheap	φτηνός
wicked	κακός
tender	τρυφερός
electric	ηλεκτρικός
sour	ξινός
vague	αμυδρός
to wad	στουμπώνω
to equate	εξισώνω
to toughen	σκληρύνω
to invigorate	ενδυναμώνω
to barbarize	εκβαρβαρώνω
to sap	υποσκάπτω
to usurp	αρπάζω
to demonstrate	διαδηλώνω
to recite	απαγγέλλω
to fondle	χαϊδεύω
sacrilegious	ιερόσυλος
unfeeling	αναίσθητος
bewildered	μπερδεμένος
licit	νόμιμος
helpless	αβοήθητος
unsuitable	ακατάλληλος
uncommon	ασυνήθιστος
convenient	κατάλληλος
celebrated	διάσημος
rotten	σάπιος
to impale	παλουκίζω
to unveil	ξεσκεπάζω
to retrench	περικόπτω
to overlay	επιστρώνω
to crumple	τσαλκώνω
to bide	περιμένω
to overload	υπερφορτώνω
to curtail	περικόπτω
to merge	συγχωνεύω
to blunt	αμβλύνω
swift	γοργός
secret	μυστικός
liquid	υγρός
humble	ταπεινός
frightful	τρομερός
neat	κομψός
hostile	εχθρικός
tedious	βαρετός
expensive	ακριβός
real	πραγματικός
to prophesy	προφητεύω
to predestine	προκαθορίζω
to forebode	προαγγέλλω
to unwind	ξετυλίγω
to illuminate	θωτίζω
to elevate	υψώνω
to rid	απαλλάσσω
to blandish	κολακεύω
to emerge	βγαίνω
to interrogate	ανακρίνω
various	διάφορος
bedridden	κατάκοιτος
snug	άνετος
exquisite	εξαίσιος
unprincipled	ανήθικος
mischievous	άτακτος
tame	ήμερος
accursed	καταραμένος
customary	συνηθισμένος
carefree	ξένοιαστος
to dabble	πλατσουρίζω
to dissolve	διαλύω
to enfeeble	αδυνατίζω
to bloat	φουσκώνω
to saunter	σουλατσάρω
to impinge	προσκρούω
to rile	εκνευρίζω
to milk	αρμέγω
to overshadow	επισκιάζω
to ford	διαβαίνω
physical	σωματικός
polite	ευγενικός
firm	σταθερός
dark	σκοτεινός
attentive	προσεκτικός
different	διαφορετικός
unique	μοναδικός
logical	λογικός
dead	νεκρός
lively	ζωηρός
to overstate	υπερβάλλω
to dapple	διαστίζω
to rollick	ξεφαντώνω
to sterilize	αποστειρώνω
to rumble	βουίζω
to expel	αποβάλλω
to cull	επιλέγω
to frequent	συχνάζω
to inculcate	ενσταλάζω
to anticipate	προλαμβάνω
impassable	αδιάβατος
hungry	πεινασμένος
smelly	δύσοσμος
ceaseless	αδιάκοπος
retired	συνταξιούχος
vicious	φαύλος
betrothed	αρραβωνιασμένος
limitless	απεριόριστος
advanced	προχωρημένος
womanly	γυναικείος
to unwrap	ξετυλίγω
to avert	αποστρέφω
to foreordain	προκαθορίζω
to daub	πασαλείβω
to unfurl	ξεδιπλώνω
to impound	κατάσχω
to congeal	πήζω
to enforce	επιβάλλω
to transpose	μεταθέτω
to invalidate	ακυρώνω
pale	χλωμός
general	γενικός
actual	πραγματικός
wet	υγρός
feminine	θηλυκός
common	κοινός
narrow	στενός
friendly	φιλικός
tragic	τραγικός
terrible	τρομερός
to nod	γνέφω
to upholster	ταπετσάρω
to soothe	καταπραϋνω
to salivate	σιελίζω
to foreshadow	προαγγέλλω
to enthrone	ενθρονίζω
to forestall	προλαμβάνω
to engage	προσλαμβάνω
to pamper	παραχαϊδεύω
to deputize	αναπληρώνω
fleeting	φευγαλέος
auspicious	ευοίωνος
immaculate	άψογος
beaten	ηττημένος
aquatic	υδρόβιος
harmless	άκακος
second	δεύτερος
ablaze	φλεγόμενος
ungrateful	αχάριστος
northern	βόρειος
to geld	ευνουχίζω
to debar	απαγορεύω
to tamper	μαστορεύω
to incarcerate	φυλακίζω
to arbitrate	διατητεύω
to grate	τρίβω
to reform	μεταρρυθμίζω
to undulate	κυματίζω
to scamper	τρέχω
to forward	διεκπεραιώνω
thin	λεπτός
sensible	λογικός
capable	ικανός
wise	σοφός
loving	στοργικός
daily	καθημερινός
peaceful	ειρινικός
possible	δυνατός
blind	τυφλός
serious	σοβαρός
to engrave	χαράσσω
to debase	εξευτελίζω
to tantalize	βασανίζω
to postpone	αναβάλλω
to cackle	κακαρίζω
to interfere	παρεμβαίνω
to rake	τσουγκρανίζω
to restate	επαναλαμβάνω
to murmur	μουρμουρίζω
to scan	ανιχνεύω
fiendish	χαιρέκακος
barren	στείρος
icy	παγωμένος
inmost	εσώτατος
sleepy	νυσταγμένος
single	ανύπαντρος
unkempt	ακατάστατος
ribald	πρόστυχος
unconquered	ανίκητος
arbitrary	αυθαίρετος
to enhance	αυξάνω
to quake	τρέμω
to muster	συγκεντρώνω
to scandalize	σκανδαλίζω
to abduct	απάγω
to freshen	δροσίζω
to spit	φτύνω
to reiterate	επαναλαμβάνω
to expand	επεκτείνω
to combine	συνδυάζω
nominated	διορισμένος
filthy	βρώμικος
animate	έμψυχος
rash	παράτολμος
pliant	εύκαμπτος
barefaced	απροκάλυπτος
faithless	άπιστος
worthless	άχρηστος
independent	ανεχάρτητος
learned	λόγιος
to exhume	εκθάβω
to disjoint	διαμελίζω
to vary	διαφέρω
to wade	βαδίζω
to capsize	αναποδογυρίζω
to bustle	σπρώχνω
to apportion	κατανέμω
to indemnify	αποζημιώνω
to ruminate	αναχαράζω
to clout	σκαμπιλίζω
wrong	λάθος
unofficial	ανεπίσημος
concerned	ανήσυχος
uneasy	ανήσυχος
foolhardy	παράτολμος
devoted	αφοσιωμένος
joyous	χαρούμενος
cursed	καταραμένος
nameless	ανώνυμος
impudent	απερίσκεπτος
to peek	κρυφοκοιτάζω
to paralyse	παραλύω
to abjure	αποκηρύσσω
to braise	σιγοψήνω
to gouge	κοιλαίνω
to recondition	ανακαινίζω
to crunch	κριτσανίζω
to miscarry	αποβάλλω
to entangle	μπερδεύω
to herald	προαγγέλλω
coiled	τυλιγμένος
later	αργότερος
following	επόμενος
boundless	απεριόριστος
genuine	γνήσιος
legal	νόμιμος
ragged	κουρελιασμένος
uninterrupted	αδιάκοπος
approved	εγκριμένος
unfading	άφθαρτος
to prohibit	απαγορεύω
to twitter	τιτιβίζω
to curd	πήζω
to trot	τροχάζω
to fumble	ψακουλεύω
to abrade	τρίβω
to braid	γαρνίρω
to dim	θαμπώνω
to untangle	ξεμπερδεύω
to enrapture	γοητεύω
frosty	παγωμένος
rigid	άκαμπτος
concealed	κρυμένος
honorable	τίμιος
unmarried	ανύπαντρος
unavailing	μάταιος
cheerful	χαρούμενος
pitiless	άσπλαχνος
upright	όρθιος
mature	ώριμος
to brighten	φωτίζω
to gag	φιμώνω
to percolate	φιλτράρω
to snare	παγιδεύω
to procure	προμηθεύω
to curdle	πήζω
to exculpate	αθωώνω
to enwrap	τυλίγω
to delve	σκαλίζω
to insure	ασφαλίζω
unfamiliar	άγνωστος
cloudy	συννεφιασμένος
unbalanced	ανισόρρωπος
unrestrained	ατίθασος
pleasing	ευχάριστος
previous	προηγούμενος
confounded	σαστισμένος
doleful	θλιμμένος
humanly	ανθρώπινος
inordinate	υπέρμετρος
to abut	συνορεύω
to broaden	φαρδαίνω
to deteriorate	χειροτερεύω
to impose	επιβάλλω
to habituate	συνηθίζω
to delete	διαγράφω
to saturate	διαποτίζω
to mutter	μουρμουρίζω
to tidy	καθαρίζω
to accouter	ενδύω
unarmed	άοπλος
illiterate	αναλφάβητος
unclean	ακάθαρτος
yearly	ετήσιος
versatile	εύστροφος
unconscious	αναίσθητος
edible	φαγώσιμος
illegitimate	νόθος
unhesitating	αδίστακτος
needless	άχρηστος
to vindicate	δικαιώνω
to electrify	ηλεκτρίζω
to permeate	διαποτίζω
to demean	εξευτελίζω
to intersperse	διασπείρω
to thwart	ματαιώνω
to bedew	δροσίζω
to black	μαυρίζω
to apprehend	συλλαμβάνω
to roughen	τραχύνω
untidy	ακατάστατος
alert	ξύπνιος
unacceptable	απαράδεκτος
unwavering	ακλόνητος
concave	κοίλος
wrongful	άδικος
confessed	ομολογημένος
handsome	όμορφος
wandering	περιπλανώμενος
impartial	αμερόληπτος
to adjoin	γειτονεύω
to intertwine	συνυφαίνω
to scintillate	σπινθηρίζω
to entrap	παγιδεύω
to gainsay	διαψεύδω
to foster	υποδαυλίζω
to incorporate	ενσωματώνω
to stagnate	λιμνάζω
to oppress	καταπιέζω
to crucify	σταυρώνω
imminent	επικείμενος
weary	κουρασμένος
meddlesome	παρείσακτος
rascally	ανέντιμος
heavenly	ουράνιος
courageous	γενναίος
recognized	αναγνωρισμένος
changeless	αμετάβλητος
refined	ραφινάτος
broken	σπασμένος
to exorcise	ξορκίζω
to drivel	σαλιαρίζω
to ensure	εξασφαλίζω
to incarnate	ενσαρκώνω
to reprint	ανατυπώνω
to chirp	τιτιβίζω
to ravish	συναρπάζω
to isolate	απομονώνω
to dispatch	διεκπεραιώνω
to trim	ψαλιδίζω
undue	αδικαιολόγητος
hopeless	άχρηστος
unbreakable	άσπαστος
deadly	μοιραίος
gleeful	χαρούμενος
uncouth	άξεστος
unintelligible	ακατανόητος
disorderly	άτακτος
ambitious	φιλόδοξος
uncongenial	ανάρμοστος
to scoop	εκσκάπτω
to discontinue	διακόπτω
to unharness	ξεζεύω
to stanch	ανακόπτω
to mutilate	ακρωτηριάζω
to deduce	συμπεραίνω
to haunt	στοιχειώνω
to import	εισάγω
to harness	τιθασεύω
to blacken	μαυρίζω
blessed	ευλογημένος
cantankerous	δύστροπος
monocular	μονόφθαλμος
notorious	διαβόητος
praiseworthy	αξιέπαινος
unchangeable	αμετάβλητος
unavoidable	αναπόφευκτος
unspeakable	ανείπωτος
fierce	άγριος
circuitous	πλάγιος
to rust	σκουριάζω
to scuff	φθείρω
to pucker	σουφρώνω
to evince	εκδηλώνω
to circumvent	παρακάμπτω
to mutate	αλλοιώνω
to wane	φθίνω
to array	παρατάσσω
to disengage	αποσυμπλέκω
to disgorge	εκβάλλω
ruthless	αδίστακτος
undamaged	άθικτος
immoral	ανήθικος
inquisitive	περίεργος
unwell	αδιάθετος
unintentional	άθελος
weird	αλλόκοτος
obedient	πειθήνιος
ungodly	άθρησκος
insignificant	ασήμαντος
to quadruplicate	τετραπλασιάζω
to nettle	ερεθίζω
to seclude	απομονώνω
to evolve	εξελίσσω
to twinkle	λαμπυρίζω
to grime	λερώνω
to quiver	τρέμω
to facilitate	διευκολύνω
to damn	καταδικάζω
to dissect	τεμαχίζω
insipid	άνοστος
wearisome	κορυρασμένος
scattered	διασκορπισμένος
undeniable	αδιάψευστος
thirsty	διψασμένος
unmerciful	άσπλαχνος
acidic	όξινος
untamed	αδάμαστος
stainless	άψογος
glowing	πυρακτωμένος
to reject	απορρίπτω
to dupe	κοροϊδεύω
to foretoken	προαγγέλλω
to designate	υποδεικνύω
to propagate	πολλαπλασιάζω
to cleave	σχίζω
to taint	μολύνω
to warp	στρεβλώνω
to stave	σπάζω
to conclude	τελειώνω
increasing	αυξανόμενος
undefeated	ανίκητος
avaricious	φιλάργυρος
funny	αστείος
spooky	απόκοσμος
winning	νικητήριος
burly	γεροδεμένος
ravenous	πειναλέος
cumbersome	δυσμετακίνητος
drawn	κουρασμένος
to excise	εκτέμνω
to refute	αντικρούω
to typify	συμβολίζω
to assort	συνταιριάζω
to juxtapose	αντιπαραθέτω
to stifle	καταπνίγω
to dodder	τρεμουλιάζω
to numb	μουδιάζω
to sequester	κατάσχω
to quench	σβήνω
famed	διάσημος
supreme	ύστατος
incarnate	ενσαρκωμένος
underprivileged	στερούμενος
bighearted	μεγαλόψυχος
nonchalant	ξέγνοιαστος
marketable	εμπορεύσιμος
untold	ανείποτος
gnarled	ροζιασμένος
formal	επίσημος
to expire	λήγω
to unburden	ξεφορτώνω
to revel	ξεφαντώνω
to distil	αποστάζω
to quiet	καθησυχάζω
to distort	διαστρεβλώνω
to revise	επαναλαμβάνω
to extemporize	αυτοσχεδιάζω
to disconnect	αποσυνδέω
to dodge	διαφεύγω
bigger	μεγαλύτερος
liberal	φιλελεύθερος
undetermined	αόριστος
untouchable	ανέγγιχτος
raving	μανιασμένος
incoming	εισερχόμενος
lettered	μορφωμένος
unmentionable	ανομολόγητος
pleasurable	ευχάριστος
moonstruck	αλαφροϊσκιωτος
to exclude	αποκλείω
to stigmatize	στιγματίζω
to sermonize	κηρύττω
to cloy	μπουχτίζω
to whet	ακονίζω
to unbutton	ξεκουμπώνω
to hallow	καθαγιάζω
to eliminate	αποκλείω
to winnow	λιχνίζω
to timber	δασώνω
asleep	κοιμώμενος
unanswerable	αναπάντατος
unreasonable	παράλογος
testy	οξύθυμος
secured	εξασφαλισμένος
requested	ζητούμενος
snappy	γρήγορος
deleted	διαγραμένος
unexplored	ανεξερεύνητος
boorish	πρόστυχος
to unify	ενώνω
to relapse	υποτροπιάζω
to backslide	ξανακυλάω
to extenuate	μετριάζω
to slobber	σαλαιαρίζω
to stipple	διαστίζω
to kidnap	απάγω
to operate	εγχειρίζω
to insert	καταχωρίζω
to whiten	ασπρίζω
gory	αιμόφυρτος
sinless	αναμάρτητος
unfailing	αδιάλειπτος
flammable	εύφλεκτος
preposterous	παράλογος
hindmost	έσχατος
lost	χαμένος
assorted	ανάμεικτος
thankless	άχαρος
unapproachable	απρόσιτος
to outweigh	υπερισχύω
to disarrange	αναστατώνω
to tweet	τιτιβίζω
to shackle	αλυσσοδένω
to err	σφάλλω
to assert	βεβαιώνω
to mortify	εξευτελίζω
to contain	περιέχω
to iterate	επαναλαμβάνω
to douse	σβήνω
moot	αμφισβητήσιμος
variable	μετάβλητος
dreamy	ονειρεμένος
fuming	εξάλλος
impervious	αδιαπέραστος
purposed	προτεινόμενος
intermediate	ενδιάμεσος
compound	σύνθετος
immutable	αμετάβλητος
consolidated	ενοποιημένος
to hamper	εμποδίζω
to baste	λιπαίνω
to exult	πανηγυρίζω
to impede	παρακωλύω
to wilt	μαραίνω
to muddle	μπερδεύω
to oust	διώχνω
to fatten	παχαίνω
to drape	πτυχώνω
to stitch	ράβω
seedy	άθλιος
unassailable	απρόσβλητος
conscientious	ευσυνείδητος
loutish	άξεστος
enhanced	βελτιωμένος
unrelenting	ασταμάτητος
stewed	βρασμένος
assumed	υποτιθέμενος
despairing	απελπισμένος
promising	υποσχώμενος
to underline	υπογραμμίζω
to harangue	αγορεύω
to drench	βρέχω
to compile	συντάσσω
to yell	ουρλιάζω
to excavate	ανασκάπτω
to eviscerate	ξεκοιλιάζω
to reassure	καθησυχάζω
to compute	υπολογίζω
to dumfound	αποσβολώνω
gallant	θαρραλέος
ingenious	πολυμήχανος
grating	δυσάρεστος
leaden	μολυβδίνος
adoptive	υιοθετημένος
troubled	ενοχλημένος
equivocal	διφορούμενος
prideful	περήφανος
unfathomable	απροσμέτρητος
weakened	εξασθενισμένος
to bedevil	πειράζω
to stun	αιφνιδιάζω
to reciprocate	ανταποδίδω
to stunt	ανακόπτω
to hearten	ενθαρρύνω
to redden	κοκκινίζω
to gamble	ποντάρω
to fawn	γλείφω
to redeem	απολυτρώνω
to ripple	ρυτιδώνω
astray	παραστρατημένος
crumbling	εύθρυπτος
cultured	πολιτισμένος
unattached	αδέσμευτος
responsive	ευαίσθητος
jaded	κουρασμένος
ornate	πλούσιος
lovely	ωραίος
unchaste	άσεμνος
unremitting	αδιάκοπος
to debauch	εκφαυλίζω
to collapse	καταρρέω
to bedraggle	κουρελιάζω
to hoarsen	βραχνιάζω
to cobble	λιθοστρώνω
to invent	εφευρίσκω
to modernize	εκσυγχρονίζω
to slash	κόβω
to stagger	τρικλίζω
to guzzle	καταβροχθίζω
bronze	μπρούτζος
thawed	ξεπαγωμένος
accidental	τυχαίος
addled	κλούβιος
unrepentant	αμετανόητος
ageless	αγέραστος
primal	πρωτόγονος
vinegary	ξιδάτος
bounteous	μεγαλόψυχος
unattainable	ανέφικτος
to deforest	αποδασώνω
to eradicate	ξεριζώνω
to decay	αποσυνθέτω
to paraphrase	παραφράζω
to graze	βόσκω
to hustle	σπεύδω
to lame	κουτσαίνω
to gulp	καταβροχθίζω
to eavesdrop	κρυφακούω
to restrict	περιορίζω
filled	γεμάτος
lovesick	ερωτοχτυπημένος
constrained	στριμωγμένος
damaging	επιζήμιος
enlightened	διαφωτισμένος
sodden	μουσκεμένος
motionless	ακίνητος
profane	ανόσιος
uncorrected	αδιόρθωτος
slain	σκοτωμένος
alike	όμοιος
unanimous	ομόφωνος
excited	συγκινημένος
obliged	υποχρεωμένος
exposed	εκτεθειμένος
senior	πρεσβύτερος
bruised	μελανιασμένος
luckless	άτυχος
available	διαθέσιμος
retarded	καθυστερημένος
crested	λοφιοφόρος
outcast	απόβλητος
aghast	εμβρόντητος
proficient	προχωρημένος
stilted	εξεζητημένος
unfeigned	απροσποίητος
unattended	ασυνόδευτος
ineffectual	ανώφελος
querulous	μεμψίμοιρος
brazen	θρασύτατος
foppish	δανδίστικος
paralysed	παράλυτος
fugitive	εφήμερος
sumptuous	πλουσιοπάροχος
unaided	αβοήθητος
eligible	κατάλληλος
babyish	μωρουδίστικος
unbecoming	ανάρμοστος
somebody	κάποιος
ludicrous	γελοίος
neglected	παραμελημένος
unexamined	ανεξέταστος
premature	πρόωρος
agile	ευκίνητος
dissolved	διαλυμένος
unflinching	άφοβος
sober	νηφάλιος
unrighteous	φαύλος
hoofed	μονόνυχος
contiguous	εφαπτόμενος
twinned	αδελφοποιημένος
mucky	βρώμικος
praised	αξιέπαινος
outgoing	εξερχόμενος
folding	πτυσσόμενος
designing	πανούργος
prying	αδιάκριτος
chancy	ριψοκίνδυνος
sensitive	ευαίσθητος
invincible	αήττητος
malicious	κακόβουλος
washed	πλυμένος
stocky	γεροδεμένος
insatiable	ακόρεστος
aquiline	αετήσιος
plumed	λοφιοφόρος
sleepless	άϋπνος
important	σημαντικός
short	κοντός
hot	ζεστός
arrogantly	υπεροπτικά
adeptly	επιδέξια
gland	ο αδένας
to outline	σκιαγραφώ
to squabble	λογομαχώ
to exhaust	εξαντλώ
to misjudge	υποτιμώ
to granulate	κοκκοποιώ
to legislate	νομοθετώ
to guarantee	εγγυώμαι
tonight	απόψε
coldly	ψυχρά
wheezy	ασθμαίνων
deceased	αποθανών
faintly	αμυδρά
briefly	σύντομα
wherever	οπουδήποτε
askew	στραβά
frankly	ειλικρινά
tearfully	δακρυσμένα
to dig	σκάβω
to spell	συλλαβίζω
to prolong	παρατείνω
to refine	ραφινάρω
to arouse	ξεσηκώνω
to cry	κλαίω
to brag	κομπάζω
to dictate	υπαγορεύω
to sob	σιγοκλαίω
to fast	νηστεύω
wooden	ξύλινος
soggy	μουσκεμένος
occupied	απασχολημένος
inattentive	απρόσεκτος
everlasting	αιώνιος
content	ικανοποιημένος
tasteless	άνοστος
gentle	ήπιος
lawful	νόμιμος
rickety	ξεχαρβαλωμένος
